ジグラード=基古拉德
レギウス=雷吉乌斯
レヴァンシア=雷万西亚
イシュタル=伊什塔尔
アリス=爱丽丝
リンリン=淋淋
ルーリエ=露莉艾
テレジア=特雷吉亚
アーシェラ=阿榭菈
バース=巴斯
アラネア=阿拉尼娅
あらねあ=阿拉尼娅
ティアリース=缇雅丽斯
ミスタリア=米斯塔莉娅
トゥリン=荼琳
マクヴァーン=马库文
プリシラ=普莉希拉
アシワラ=阿西乌罗
ヒミカ=绯弥香
イザヨイ=十六夜
ごじょう=五条
くろう=久良
やなしろ=柳城
まさかげ=正景
クナ=库娜
ルガリア=卢伽利亚
アルカーラ=阿尔卡拉
ハリアル=哈利艾尔
テリオン=特里昂
ラミリアーク=拉米利亚克
イーニア=伊妮娅
ジルディス=基尔迪斯
エリシャ=埃莉莎
エレシュキガル=埃列什基伽尔
ネルガル=内尔伽尔
エンキドゥ=恩奇都
シビリアン=天仆
サタニス=魔徒
アーシェラ悪=悪 阿榭菈
ヒミカ悪=悪 绯弥香
ミスタリア悪=悪 米斯塔莉娅

エビス=惠比寿
アムルタート=阿姆塔特



ニンフルサグ=宁胡尔萨格
アルタイス=阿尔泰斯
タリスマン=徽章
ギルガメシュ=吉尔伽美什



スーパー剣兵=超级剑兵
カオティックカノン=混沌加农炮
ウルティマカノン=终结加农炮
ヴァルボリの魔女=瓦尔堡的魔女
ハイモンク=高等武僧
ハイエロファント=高等神官
ハイプリエステス=高等牧师
フューリー=禁术兵
バイキングリーダー=维京首领
オリファンの笛吹き=号角传令兵
インヴォーカー=祷告者
ドラゴンナイト=龙骑士
レディドラゴンナイト=龙骑士姬
カーディナル=主教
ブラストドラグーン=爆裂龙骑兵
セージ=贤者
レディセージ=女贤者
レディアーチボルト=攻城女炮兵
アーチボルト=攻城弩兵
ウォリアー=巨剑战士
レディウォリアー=巨斧女战士
クルセイダー=神官
レディクルセイダー=女神官
アサシン=刺客
レディアサシン=女刺客
ハルモニアナイツ=亚马逊骑士
ハルモニアガード=亚马逊盾卫
アマゾンブレイダー=亚马逊剑士
アマゾンスナイパー=亚马逊射手
アマゾンドルイド=亚马逊德鲁伊
アマゾネス=亚马逊女战士
ヴァイスリッター=天马骑士长
フォビドゥーン=禁忌森民
レディロードナイト=女骑士长
ロードナイト=骑士长
スナイパー=精锐弓手
レディスナイパー=精锐女弓手
グラディエーター=角斗士
ウィングドラグーン=翼龙骑士
ヴァイスマギア=白魔道士
フォートレス=护卫
レディフォートレス=女护卫
バーバリアン=野蛮人
ホーンドラグーン=角龙女骑士
ドラゴンプリースト=龙祭司
クロウドラグーン=龙爪女战士
グリフォンライダー=狮鹫骑士
ゲイルリッター=天马骑士
シーア=占卜师
陰陽師=阴阳师
エレメンタラー=冰灵法师
ハンマーナイト=铁锤骑士
スケイルドラグーン=刚鳞龙骑兵
パニッシャー=惩戒者
レディホーク=维京女杰
バイキングガード=维京守卫
チャリオット=战车骑兵
パイレーツ=海盗
バッカニア=女海盗
ビーストライダー=野兽骑士
エグゼクター=暗杀者
ベノムトレーダー=毒师
ナイト=骑士
レディナイト=女骑士
バウンサー=枪兵
レディローグ=女混混
ローグ=混混
ウィザード=魔术师
ウィッチ=女巫
ファウスト=咒术师
ソルジャー=士兵
レディソルジャー=女兵
ファイター=战士
レディファイター=女战士
アーチャー=弓手
レディアーチャー=女弓手
ノーマッド=游牧民
ハーバリスト=草药师
クロスボウマン=十字弓兵
カーペンター=木工
マキシマムオーガ=最强食人魔
アルビオン=阿尔比恩
クイーン・アクエリア=女王阿库艾丽娅
メジェドちゃん=梅杰德酱
ウジャト=乌吉特
バステト=巴斯泰托
アウルゲルミル=奥格尔米尔
ナラシンハジェネラル=狮人族将军
ギガースヴァンガード=巨人急先锋
ムスペルランダー=炎魔穆斯贝尔
ギガースジェネラル=巨人将军
エルダーギガース=巨人长老
ガロードエスクード=加洛特骑士
リュカオン=莱卡翁
リザードロード=蜥蜴人头领
ミルクイーン=蚌女王
ベルゲルミル=贝格尔米尔
ラビナスハーベスター=兔人收割者
ケット・シー=凯特・西
ギガースレイダー=巨人侵攻者
コボルドメシア=犬人弥赛亚
ガロードスナイパー=加洛特狙击手
ウォーウルフ=战狼
サイクロプス=独眼巨人
ギガースナイト=巨人骑士
ガロードインペイラー=加洛特枪兵长
オークリーダー=猪人头领
アーマートロール=铁头巨魔
ツインマーフォーク=人鱼双子
オーガ=食人魔
ゴブリンキング=哥布林国王
オークデモリッシュ=猪人破坏者
コボルドシェフ=犬人厨师
ナラシンハ=狮人族战士
リザードジェネラル=蜥蜴人将军
コボルドケミスト=犬人化学家
カアスマドモアゼル=卡斯族小姐姐
グリプスフォーク=狮鹫战士
アルミラージ=独角兔
ケルピーライダー=凯尔比骑士
リザードソルジャー=蜥蜴人战士
オーキシュライダー=半猪人骑手
メジェド=梅杰德
カウガール=牛女郎
オーキシュガンナー=半猪人枪手
ホルスタウロス=奶牛人
ホルス=荷鲁斯
トロール=巨魔
コボルドボマー=犬人投弹兵
キャリアウーワン=职场汪女士
ラタトスク=拉塔托斯克
コボルドフェンサー=犬人剑姬
ガロードランサー=加洛特枪兵
功夫マシラ=功夫猿
ホークメイジ=鹰术士
コボルドメイジ=犬人魔术师
コボルドエンジニア=犬人工程师
ワーキャット=战猫
ゴブリンライダー=哥布林骑士
ホークナイト=鹰骑士
オーキシュマリーン=半猪人水手
ゴブリンスミス=哥布林煅冶师
ミノタウロス=牛头人
マーマン=鱼人
ゴブリンガール=哥布林女郎
ゴブリン=哥布林
ハーピー=鹰身人
コボルドハンター=犬人猎手
ガロード=加洛特
マーメイド=美人鱼
サハギン=半鱼人
カアス=蛇妖兵
オークガード=猪人守卫
ポントス=蓬托斯
フンババ=洪巴巴
テスカトリポカ=泰兹卡特里波卡
ベヒモス=贝希摩斯
ジズ=席兹
ヒルディス=希尔帝斯
シムルグ=斯摩夫
蛇神カドゥルー=蛇神迦德卢
ダンタリオン=但他林
グラシャラボラス=格剌西亚拉波斯
アンドロマリウス=安杜马利乌士
ラードーン=拉冬
セルケト=塞尔凯特
アンフィスバエナ=双头蛇
サンダーバード=雷鸟
サタナスアイ=撒旦之眼
カリブディス=卡律布狄斯
オブシダンタイガー=黑曜虎
タイラントイール=霸王鳝
ノーザンワルラス=北地海象
テラーベア=恐怖熊
シーモンスター=鮟鱇怪
怪樹マヤ=怪树玛亚
カトブレパス=卡托布莱帕斯
クラーケン=克拉肯
シグムンド=西格蒙德
ジュエルビースト=宝石兽
イエティ=雪猿
ケルベロス=地狱三头犬
スフィンクス=斯芬克斯
バジリスク=毒蜥
スパイクビースト=刺兽
アルマジュエル=宝石犰狳
キングコブラ=眼镜蛇
マンティコア=狮蝎
ケルコロン=地狱三头犬宝宝
グリフォン=狮鹫
アイスペンギン=冰企鹅
ブリザードベア=暴雪熊
ラミア=拉米亚
コカトリス=鸡蛇
イビルアイ=邪眼
アイアンタートル=钢铁龟
アラクネ=阿拉克涅
スキュラ=斯库拉
チックガルダ=火稚鸟
イモザラシ=多手虫
闇アリクイ=暗食蚁兽
まりもラット=藻鼠
デスフロッグ=死亡蟾蜍
アプスー=阿普苏
ルナティクスドラグス=疯树龙
セフィラドラグス=瑟菲拉龙
ルナティクスアニマ=疯狂之灵
マッドスカラーＳ=疯狂学者S
ルナティクスビースト=疯兽
セフィラアニマ=瑟菲拉之灵
セフィラビースト=瑟菲拉兽
イルミンスール=伊尔敏苏尔
クイーンドラセナリア=龙血树女王
バイコーンポーチャー=梦魇狙击手
ルナティクスシード=疯狂种子
ミザリー=米扎利
クーフーリン=库夫林
ティターニア=提泰妮娅
ドラセナリア=龙血树精
セフィラシード=瑟菲拉种子
プーカ=普卡精
ラナンシー=菈南希
ドワーフキング=矮人王
バロメッツイーター=巴洛梅兹捕食者
スイカオーランタン=西瓜灯
ノクターンスカラー=暗精学者
氷の女王=氷女王
カルキノス=蟹骑士姬
ジーンブレイズ=炎剑灵
ルークセントール=人马骑士
ビブリオマニア=书虫妖精
エルヴンサマナー=精灵召唤师
エルヴンナイト=精灵骑士
エルヴンストライカー=精灵拳术师
カクタスガール・メロ=仙人掌娘・梅洛
ユニコーンスナイパー=独角兽狙击手
ユニコライダー=独角兽骑士
スネグラチカ=雪妖精
アイスエント=冰雪树人
メリアス=墨利亚斯
ロリドゥラキア=萝莉树龙
ドワーフファイター=矮人战士
ファンガスコック=蘑菇厨娘
ノクターンブレイド=暗精剑士
ケンタウルス=人马
エルヴンハーミット=精灵隐士
ドワーフガーダー=矮人守卫
ネーレウス=卢莎卡
エルヴンシャーマン=精灵萨满
ソードジーニ=剑灵
シルフィード=希尔芙
レディ・マシュルムス=蘑菇小姐
ドライアド=树妖
アルラウネ=爱娜温
ホビットスカウト=霍比特斥候
エルヴンブレイダー=精灵剑士
バンブーチャイルド=竹童
ホビットハンター=霍比特猎人
サテュロス=萨提洛斯
カクタスガール・マミ=仙人掌娘・玛米
リトルウィスパー=轻语小妖精
ユニコロン=独角兽
マンドラゴラ=曼德拉草
レモラ=鮣鱼精
フェアリー=妖精
マタンゴレディ=蘑菇女
ベビーアルラウネ=爱娜温幼女
サタン=撒旦
パズス=帕祖斯
ルキフェル=路西法
フォルカロル=弗卡洛
ウェパル=威帕尔
メフィストフェレス=梅菲斯特
キマリス=基马里斯
マモン=玛门
オプスヴァルカン=单眼冶炼师
グシオン=古西昂
デーモンブレイブ=恶魔勇者
フォルネウス=弗内乌斯
デカラビア=单卡拉比
ガープ=嘉波
ヴァサーゴ=瓦沙克
ベレト=布锐斯
パイモン=派蒙
シトリー=西迪
ナーガ=娜迦
バルログ=炎魔
プロケル=普罗克尔
リリス=莉莉丝
アークデーモン=大恶魔
ボルトアベンジャー=电光复仇者
アスモデ=阿斯蒙德
アスタルテ=阿斯塔特
デーモンエグゼクター=恶魔刽子手
グリモアデーモン=魔典恶魔
デーモンアリスト=恶魔贵族
ナベリウス=纳贝流士
マリオネッター=提线木偶
エンプーサ=恩浦萨
デビルコック=恶魔厨师
デビルナース=恶魔护士
グレムリン=格雷姆林
インキュバス=梦魔
サキュバス=魅魔
デーモンナイト=恶魔骑士
バロン=恶魔男爵
オプスメイジ=单眼术士
クルラホーン=克鲁拉霍恩
ゴーゴン=蛇发女妖
デーモンレイダー=恶魔侵攻者
フレイムスロワー=喷火恶魔兵
ドリームシープ=梦羊
イビルライダー=魔族舵手
デビルファーマー=魔族农夫
デビル=魔鬼
エンジェルインプ=天使小恶魔
インプ=小恶魔
レプラコーン=矮精灵
ヴォイドデューク=虚空公爵
ヴォイドマーダラー=虚空处刑人
ヴォイドアグレッサー=虚空侵攻者
ヴォイドスリンガー=虚空射手
ヴォイドロウヤー=虚空判官
ヴォイドプリズナー=虚空囚犯
ヴォイドフィロソファ=虚空哲人
アビサルデューク=冥府公爵
アビサルマーダラー=冥府处刑人
アビサルアグレッサー=冥府侵攻者
アビサルスリンガー=冥府射手
アビサルロウヤー=冥府判官
アビサルプリズナー=冥府囚犯
アビサルフィロソファ=冥府哲人
クレニウム＝デヴリス=狱炎骸龙
プロセルピナ=普洛塞庇娜
デスブリンガー=死亡使者
ペルヴィス＝デヴリス=骸角龙
ティルス＝デヴリス=狱炎骸兽
スパイン＝デヴリス=骸脊龙
ドゥームプリンセス=厄运公主
アヌビス=阿努比斯
ドラゴンゾンビ=尸龙
レヴナント=亡魂
ボーンドラゴン=骨龙
リッチ=巫妖
ワイトクイーン=白灵女王
ブラッドプリンセス=吸血鬼公主
デスドラグーン=死亡龙骑兵
ノーライフキング=无命女王
マスターブレイド=剑术大尸
アサルトガンナー=突击死枪兵
ベルセルク=狂战尸
イビルボマー=邪怨爆破者
ゴーストシップ=幽灵船
ドゥームナイト=厄运骑士
ウルナ＝デヴリス=骸兽乌尔纳
ホーンテッドハウス=鬼屋
カーフ＝デヴリス=独眼骸牛
ヴァンパイアロード=吸血鬼领主
ドゥームメイジ=厄运法师
ノスフェラトゥ=诺斯费拉图
パテラ＝デヴリス=骸兽帕特拉
カースソード=诅咒剑灵
アイアンメイデン=铁处女
ヴァンパイア=吸血鬼
ソウルサッカー=魂蹴师
スピリット=灵魂
ジャックオーランタン=南瓜灯
マンイーター=食人宝箱
ニトロマンサー=硝化术士
ボーンナイト=骨骑士
バンシー=报丧女妖
ファントム=幻影
ダンピール=半吸血鬼
フレッシュゴーレム=活体魔像
デュラハン=杜拉罕
ボーングラップラー=骨斗家
ダークストーカー=暗黑追踪者
グール=食尸鬼
ミイラ女=木乃伊女
スケルトンメイジ=骷髅法师
レッドスケルトン=红骷髅
ゾンビメイデン=僵尸少女
ゾンビコック=僵尸厨师
マレウス＝デヴリス=颚骨蝠
ポルターガイスト=骚灵
ゴースト=幽灵
スケルトン=骷髅
ファルスセラフ=虚造炽天使
ファルスケルビム=虚造智天使
ファルスデュナミス=虚造力天使
ファルスガルガリン=虚造座天使
ファルスエクスシア=虚造能天使
ファルスドミニオン=虚造主天使
ファルスアルカンジェ=虚造大天使
アルカイックドラゴン=终末古龙
マザーミミック=宝箱怪之母
スサノオ=须佐能乎命
フォージセラフ=造炽天使
フォージケルビム=造智天使
フォージガルガリン=造座天使
フォージエクスシア=造能天使
フォージデュナミス=造力天使
フォージドミニオン=造主天使
フォージアルカンジェ=造大天使
イズン=伊顿
エンブリオアドミラル=机人司令
エンブリオジェネラル=机人将军
デモンドール=恶魔人偶
パンドラ=潘多拉
ＲＧヘラクレス=RG赫拉克勒斯
ＲＧアタランテ=RG亚特兰大
ＲＧペルセウス=RG珀尔修斯
キャンディハウス=糖果屋
マシンドラゴン=机械龙
オリハルコンマン=山铜人
マシンサウルス=机械暴龙
アトレウス=阿特柔斯
スケアクロウ・マータ=稻草人偶
エーテルモノリス=以太壁
ミミックバーガー=汉堡怪
スライムクイーン=史莱姆女王
フェイクウォール=陷阱墙
レイスソルダート=灵想战士
レイスガード=灵想守卫
レイスマギア=灵想术士
レイスライダー=灵想骑士
マグマゴーレム=岩浆魔像
クッキングママ=厨妈妈
キラードール=杀手人偶
フラットボディ=火机人偶
パペッティア=自动人偶
ゼラチナスキューブ=黏胶立方
メルカバ=梅卡瓦机兵
キリングメイド=杀戮女仆
セキュリティロボ=安全机器人
ヤーボドラゴン=机械幼龙
エーテルブレイダー=以太剑士
エーテルガーダー=以太守卫
エーテルウィスプ=以太鬼火
エーテルアサルト=以太突击兵
エーテルガンナー=以太枪手
ジェットランサー=喷射枪兵
ミミック=宝箱怪
パペットマスター=人偶大师
アイススタチュー=冰巨像
ブラッドマータ=屠血人偶
アルケフェアリー=器兵妖精女王
センチュリオン=百夫长机兵
ネガフレイム=冰火少女
ラビリンシー=迷宫妖精
人喰いボックス=食人箱
ロックマン=石人
ストーンフォートレス=石像堡垒
カーバンクルナイト=宝玉骑士
リビングスタチュー=石巨像
スライムレディ=史莱姆娘
ポンコツメイド=废柴女仆
スクラップイーター=废料史莱姆
ガーゴイル=石像鬼
スライム=史莱姆
ウロボロス=乌洛波洛斯
ビッグバンドラゴン=大爆炸巨炮龙
覇竜ミズガルズ=霸龙米兹加尔斯
虹竜イピリア=虹龙伊皮里亚
ジャバウォック=炸脖龙
コロッサルドラゴン=巨炮龙
ドラゴンソウル=龙魂
ウルクジェネラル=神龙将軍
ガルグイユ=七色宝石龙
母竜エキドナ=母龙埃奇德娜
アイアタル=冰龙
腐竜アウドムラ=腐龙奥杜姆拉
アビスヒュドラ=深渊多头龙
ウルクナイト=神龙骑士
ウルクエンフォーサー=神龙弓士
ドラゴンパニッシャー=龙人惩罚者
ファントムドラゴン=幻影龙
ウルクプリースト=神龙牧师
ドラゴンアルケミスト=龙娘炼金士
クリスタルドラゴン=水晶龙
ゴールドドラゴン=金龙
シルバードラゴン=银龙
ドラゴンウィッチ=龙之魔女
ドラゴンウィザード=龙之魔术师
レイクヒュドラ=湖栖多头蛇
ウィルムジェネラル=天龙将军
アーマードラゴン=装甲龙
ドラゴンハーピスト=龙之竖琴师
フェザーサジタリス=羽龙射手
フェザーミディアム=羽龙灵媒师
ドラゴンシールダー=龙之盾卫
ブネ=布涅
フェザーナイト=羽龙骑士
サラマンダー=萨拉曼达
アクアドラゴン=水龙
ストームドラゴン=风龙
アースドラゴン=地龙
ダークドラゴン=暗龙
ファイアドラゴン=火龙
ウィルムセイバー=天龙剑士
ウィルムサマナー=天龙召唤师
ガストサーペント=毒雷蛇
ワイバーン=翼龙
ウィルムルーク=天龙士兵
マグマサーペント=熔岩蛇
ウィルムドルイド=天龙祭司
ドラゴンディーバ=龙之歌姬
ドラゴニュート=龙人
ドルガンメイジ=地龙法师
ドルガンソルジャー=地龙士兵
シーサーペント=海蛇
ドラゴバルーン=小龙球
ドラゴンパピー=龙宝宝
混沌蟲アバドン=混沌虫阿巴顿
ガイアスセイバー=盖亚种剑圣
ガイアスデューク=盖亚种公爵
魔蝕姫マイノグーラ=魔蚀姬麦诺古拉
変異獣ドグマ=变异兽多格玛
アトラクナクア=深渊触手姬
禁獣アバドン=禁兽阿巴顿
ガイアスアキテクト=盖亚缔造种
ビョルキリー=触手战少女
変異獣プラトナム=变异兽普拉特纳姆
ラビリンスキーパー=迷宫看护者
パラミシア=帕拉米西亚
変異獣ギグス=变异兽吉格斯
変異獣ストローワ=变异兽斯特洛瓦
ガイアスミディアム=盖亚种巫女
バルバ・ドラグス=真兽多拉格斯
変異獣ペストール=变异兽佩斯特尔
変異獣マリガント=变异兽马力冈特
バルバ・タウロス=真兽陶洛斯
クイーンズビー=女王蜂
キメラホーネット=奇美拉蜂
バルバ・ストレイ=真兽斯特雷
異獣ドベル=异兽多贝尔
ワームクイーン=虫女王
異獣プラタルス=异兽普拉塔路斯
ガイアスキャリア=盖亚下位种
異獣キャンサード=异兽佳恩萨德
異獣ディムソーサ=异兽蒂姆索萨
ココペルマナ=可可佩尔玛呐
異獣ベヌフライ=异兽贝诺弗莱
異獣バグス=异兽巴格斯
ランドクロウラー=爬行巨虫
キラービー=杀人蜂
イザナミ=伊邪那美
アマハバキリ=天羽羽斩
はやて=飒
ぬらりひょん=滑头鬼
だいだらぼっち=大太法师
ヤマタノオロチ=八岐大蛇
オオゲツヒメ=大宜津比麦
ルナ=露娜
アマビエ=阿玛比埃
砂かけロリばばあ=踢砂萝莉婆婆
カラス天狗=鸦天狗
ネコマタ=猫又
はまぐり女房=蛤蜊夫人
ポンポコ忍者=狸猫忍者
ユキンコ=雪童双子
ゆきだるま=雪人
キツネ巫女=狐巫女
カーリー=迦梨
シヴァ=湿婆
ネメシスジャッジ=复仇审判者
ネメシスセージ=复仇贤者
ネメシスナイト=复仇骑士
ネメシスコーラー=复仇传播者
ネメシスガンナー=复仇枪手
ネプチューン=尼普顿
ウラノス=乌拉诺斯
プルート=普鲁托
熾天使ミカエル=炽天使米迦勒
熾天使メタトロン=炽天使梅塔特隆
熾天使ラファエル=炽天使拉斐尔
熾天使ラジエル=炽天使拉结尔
熾天使ハニエル=炽天使哈尼尔
熾天使アキベエル=炽天使阿琪贝尔
熾天使ウリエル=炽天使乌列尔
熾天使ゼルエル=炽天使塞路尔
熾天使サンダルフォン=炽天使圣德芬
熾天使ジョフィエル=炽天使约菲尔
熾天使ザラキエル=炽天使泽拉凯尔
熾天使ガブリエル=炽天使加百列
リンドヴルム=林德沃姆
イノセントグランツ=无垢之光
イノセントソード=无垢剑士
イノセントシェル=无垢盾骑士
イノセントチャンター=无垢圣歌术士
エバンジールナイト=福音骑士
エバンジールジャッジ=福音审判者
エバンジールガンナー=福音枪手
エバンジールセージ=福音贤者
エバンジールコーラー=福音传播者
ガネーシャ=迦尼萨
セラフ=撒拉弗
スレイプニルの神騎士=斯莱普尼尔的神骑士
アリアドネー=阿里阿德涅
アフィストル=天使司令
ドミネーター=堕天司令
シグルズの竜戦士=龙战士希格鲁斯
スルーズの雷騎士=雷骑士斯露德
アルヴィスの賢者=贤者阿尔维斯
ノートスの天弓士=天弓士诺特
グリゴリ=格里戈里
キュベレイ=丘贝利
エンジェルセイバー=天使剑士
ガルーダ=迦楼罗
エンジェルチャンター=天使歌者
エンジェルナイト=天使骑士
エンジェルコック=天使厨师
スプライトシーカー=雷箭精灵
ヘブンインペイル=天堂枪兵
ヘブンレイダー=天堂剑士
アマテラス=天照
フォールンセイバー=堕落剑士
フォールンチャンター=堕落歌者
アレイオーン=阿里昂
ヴァルファーズ=黄金战魂
ヴァルキリー=女武神
フォルエンジェル=堕天使
スレイエンジェル=杀戮天使
カオスエンジェル=混沌天使
クピド=丘比特
ヘイズルーン=海德伦
ケリュネイア=刻律涅牝
エインヘリヤル=英灵战士
ファレンクピド=堕落丘比特
セイレーン=塞壬
混沌の神アシェラト=混沌之神阿榭拉特
スレイプニルオルク=蚀之神骑士
混沌の母イドラ=混沌之母伊德海拉
グラシア・イラ=黑晶・怒
グラシア・アモーレ=黑晶・爱
グラシア・プラセル=黑晶・喜
グラシア・トリステサ=黑晶・悲
グラシア・ファーシル=黑晶・乐
イボルヴプレデター=进化捕食体
イボルヴユニオン=进化共生体
イボルヴグロウナー=进化种植体
イボルヴイムニティ=进化免疫体
レインボードロゴーン=虹色破坏兽
サタナスドロゴーン=暗黒破坏兽
ウルティマドロゴーン=机械破坏兽
ディバインドロゴーン=神光破坏兽
恐影の覇竜=恐影之霸龙
恐影のヒュドラ=恐影多头龙
恐影の骸竜=恐影之骸龙
恐影の装甲竜=恐影装甲龙
カラミティマーメイド=灾祸美人鱼
カラミティドラグーン=灾祸龙骑将
カラミティリーパー=灾祸收割者
カラミティスカラー=灾祸学者
カラミティデスナイト=灾祸死亡骑士
カラミティブレイダー=灾祸剑士
カラミティハーミット=灾祸隐士
カラミティプリースト=灾祸牧师
シグルズオルク=蚀之希格鲁斯
スルーズオルク=蚀之斯露德
ノートスオルク=蚀之诺特
アルヴィスオルク=蚀之阿尔维斯
アウルゲルミルオルク=蚀之暗魔
ムスペルランドオルク=蚀之炎魔
ベルゲルミルオルク=蚀之贝格尔
ヴァルキリーオルク=蚀之女武神
ヘイズルーンオルク=蚀之海德伦
ヴァルファーズオルク=蚀之战魂
エインヘリヤルオルク=蚀之英灵
ラグナ・イラ=结晶・怒
ラグナ・アモーレ=结晶・爱
ラグナ・トリステサ=结晶・悲
ラグナ・ファーシル=结晶・乐
ラグナ・プラセル=结晶・喜
アーキアングロウナー=阿基安种植体
アーキアンイムニティ=阿基安免疫体
アーキアンプレデター=阿基安捕食体
アーキアンユニオン=阿基安共生体
海神ナハール=海神纳哈尔
屍神レシェフ=尸神雷瑟夫
炎神モート=炎神摩特
嵐神アナト=岚神阿娜特
狂天使アザゼル=狂天使阿萨兹勒
狂天使イブリース=狂天使易卜劣斯
狂天使アラキバ=狂天使乌拉卡巴
狂天使カスピエル=狂天使加斯伯禄
狂天使サマエル=狂天使萨麦尔
狂天使ラメエル=狂天使耶利米尔
フォモル=弗莫尔
バアルウォリアー=异形战士
バアルメイガス=异形魔术师
混沌の胤=混沌之胤

触神=触神
触王=触王
触手姫=触手姫
触手男爵=触手男爵
食竜花=食竜花
霊装鎧兵=霊装鎧兵
女霊装鎧兵=女霊装鎧兵
金鎧将=金鎧将
黒騎将=黒騎将
剣豪=剣豪
武仙=武仙
仙女=仙女
拳聖=拳聖
女拳聖=女拳聖
黒騎士=黒騎士
鉄騎将=鉄騎将
聖騎士=聖騎士
忍者=忍者
司祭=司祭
山師=山師
辺境盾兵=辺境盾兵
銃士隊長=銃士隊長
屍破犬=屍破犬
雪女将=雪女将
牛鬼=牛鬼
狂骨=狂骨
海坊主=海坊主
文車妖妃=文車妖妃
楓=楓
金霊=金霊
火車=火車
大鬼=大鬼
天邪鬼=天邪鬼
三霊狐=三霊狐
河童=河童
管狐=管狐
言見聞猿=言見聞猿
妖狐=妖狐
馬頭=馬面
地獄蝶=地獄蝶
般若武者=般若武者
大酒虫=大酒虫
大百足姫=大百足姫
焔雉子=焔雉子
酒呑童子=酒呑童子
一目連=一目連
天帝梵阿=天帝梵阿
死神司録=死神司録
神威大蛇=神威大蛇
龍厨師=龍厨師
華竜術士=華竜術士
華竜刀士=華竜刀士
竜宮の姫=竜宮の姫
華竜弓士=華竜弓士
華竜忍者=華竜忍者
華竜騎士=華竜騎士
華竜巫女=華竜巫女
深淵の古竜=深淵古竜
海原の古竜=海原古竜
煉獄の古竜=煉獄古竜
大嵐の古竜=大嵐古竜
岩窟の古竜=岩窟古竜
怪盗=怪盗
侍=侍
死神見習い=死神見習
死神長=死神長
死神総長=死神総長
腐食竜花=腐食竜花
蟲狼竜=蟲狼竜
腐毒狼竜=腐毒狼竜
青龍=青龍
白虎=白虎
麒麟=麒麟
応龍=応龍
朱雀=朱雀
玄武=玄武
阿修羅=阿修羅
桃太狼=桃太狼
迦楼羅天=迦楼羅天
黒龍王=黒龍王
女剣豪=女剣豪
雪女=雪女
巫女=巫女
牛頭=牛頭
魔装機竜兵=魔装機竜兵
鬼娘=鬼娘
侍大将=侍大将
高司祭=高司祭
騎兵銃士=騎兵銃士
武士=武士
女武者=女武者
銃士=銃士
触主=触主
鬼燐百足=鬼燐百足
屍巫女=屍巫女
閻魔厨師=閻魔厨師


メイドの少女=女仆模样的少女
神殿騎士たち=神殿騎士们
魔族たち=魔族们
テレジア兵=特雷吉亚兵
魔族の子供=魔族的孩子
オーガ兵=食人魔士兵
テレジアの民=特雷吉亚的人民
魔王に扮した子供=扮演魔王的孩子
悪魔族の少年=悪魔族的少年
レオ=雷欧
リディア=莉迪娅
孤児院の=孤儿院的
子供=孩子
サリシャ=萨莉莎
エリシャ？=埃莉莎？
ラビナスの=兔人族的
ハッチ=哈奇
戦士=战士
サムライ弐=武士二
サムライ壱=武士一
サムライ肆=武士四
サムライ参=武士三
モニカ=莫妮卡
エルフ長老Ａ=精灵长老Ａ
エルフ長老Ｂ=精灵长老Ｂ
エルフ長老Ｃ=精灵长老Ｃ
エルトリア=艾尔托丽雅


炎の獣=炎獣
オーク兵=猪人兵
オーク隊長=猪人队长
野蛮な男Ａ=野蛮男子Ａ
野蛮な男Ｂ=野蛮男子Ｂ
野蛮な男Ｃ=野蛮男子Ｃ
魔徒の少女=魔徒少女
魔族の女=女魔族

バルドラス兵=巴尔德拉斯兵
バルドラスの民=巴尔德拉斯的民众
バルドラス兵士=巴尔德拉斯士兵
アシワラ武将=阿西乌罗武将
海兵たち=海兵们

幼い日の=小时候的
スライム触手=史莱姆触手
亡者たち=亡者们
少年たち=少年们
魔族の=魔族的
妖精郷の=妖精郷的
住人=住人
老エルフ=老精灵
エルフの民=精灵民众
魔王軍の=魔王軍的
兵たち=兵们
住人たち=住人们
フウバ=伏巴
冥府の獄卒=冥府的獄卒
幼魔たち=幼魔们

エルフの姉妹=精灵姐妹
ファンナ=芬娜
市民たち=市民们
幼魔=幼魔
魔王軍空戦兵=魔王軍空戦兵
怪物=怪物
海兵Ａ=海兵Ａ
海兵Ｂ=海兵Ｂ
海兵Ｃ=海兵Ｃ
船長=船長
市長=市長
街の住人=街之住人
壮年の男=壮年男性
天使兵=天使兵
店員=店員
魔族兵Ａ=魔族兵Ａ
魔族兵Ｂ=魔族兵Ｂ
賊Ａ=賊Ａ
賊Ｂ=賊Ｂ
賊Ｃ=賊Ｃ
賊長=賊長
占星院の兵=占星院的兵
民=民
獣人の=獣人的
子供魔王=子供魔王
魔族兵=魔族兵
魔族赤子=魔族赤子
魔族母=魔族母
迷宮工兵=迷宮工兵
騎士=騎士
騎士団長=騎士団長
従騎士=従騎士
婦人=婦人
老人=老人
不死兵=不死兵
ガロードの=加洛特的
同輩=同輩
少年の=少年的
魔族Ａ=魔族Ａ
魔族Ｂ=魔族Ｂ
魔族Ｃ=魔族Ｃ
魔族新兵Ａ=魔族新兵Ａ
魔族新兵Ｂ=魔族新兵Ｂ
魔族新兵Ｃ=魔族新兵Ｃ
魔族の男=魔族男性
紳士=紳士
市民=市民
坊主=坊主
少年=少年
信徒=信徒
青年=青年

神殿騎士Ａ=神殿騎士Ａ
神殿騎士Ｂ=神殿騎士Ｂ
神殿騎士=神殿騎士
魔族兵士=魔族兵士
魔族=魔族
亡者=亡者
冥界の精霊=冥界的精霊
勇者達=勇者達
狐狼族族長=狐狼族族長
魔王軍将兵=魔王軍将兵
アビスの=深渊之
魔族兵士Ａ=魔族兵士Ａ
魔族兵士Ｂ=魔族兵士Ｂ
アルカーラ＆ハリアル=阿尔卡拉＆哈利艾尔
テレジアの=特雷吉亚的
民Ａ=民Ａ
民Ｂ=民Ｂ
民Ｃ=民Ｃ
民Ｄ=民Ｄ
街の子供=街上的孩子
獣人兵=獣人兵
兵士=兵士
エルフの=精灵的
エルフの娘=精灵少女
若者=年轻人
少女=少女
夜刀衆の=夜刀衆的
夜刀衆の娘=夜刀衆的少女
少女・壱=少女・一
少女・弐=少女・二
家臣=家臣
妖怪の=妖怪的
ガロード少年=加洛特少年
お客=客人
客=客










#set level 5
魔王軍=  魔王军
テレジア軍=  特雷吉亚军
アンノウン=  未知
ティアリース軍=  缇雅丽斯军
アシワラ軍=  阿西乌罗军
バルドラス軍=  巴尔德拉斯军
ルガリア軍=  卢伽利亚军
冥界軍=  冥界軍
アーキアン=  阿基安
ニンフルサグ軍=  宁胡尔萨格军
