——亚人——
マキ割りダイナマイト=斧子狂砍
羽毛ビンタ=羽毛拍打
ワイナーショット=俺的射击
マーメイドリサイタル=人鱼的歌会
ウォーターガン=水弹枪
コブラショット=眼镜蛇射击
養豚流究極奥義・豚飯=养猪流终极奥义 猪饭
ガロード・クラッシュ=加洛特劈砍
スミシー・ボム=煅冶师炸弹
牛胆流極技・座布団=牛胆流绝技・坐垫
マッソゥボマー=肌肉炸弹
スキあり=有翼蚂蚁
ニャンクロー=喵爪
アサルト・アタック=突击
スパイラル・ブリッツ=螺旋突击
水中工作=水中工作
ポイズン・ファング=毒牙
ファイア・レイピア=火焰刺剑
ガロード・エイミング=加洛特狙击
十六手拳=十六手拳
マジックミサイル=魔术导弹
コボフレイム=狗狗火焰
クイックリペアー=快速修理
フリージアの戦陣=小苍兰的战阵
ぴーすけラッシュ=皮助突进
ソルジャーアタック=士兵攻击
脳削りチャージ=劈脑冲撞
ＥＹＥ・ＢＥＡＭ=ＥＹＥ・ＢＥＡＭ
ガンブレイズバースト=爆裂枪火
リベンジ・スナイプ=复仇乱射
ホルスタイン・ガード=奶牛防御
トロール・インパクト=巨魔猛击
粉砕・爆砕・大喝采=粉碎、爆炸、大喝彩
うわ、貴方年収低すぎ=哇，你年收入太低了
獅子の大剣=狮子的大剑
トカゲ流槍術=蜥蜴流枪术
ケミストリ・ファイア=化学火灾
毒蛇の輪舞曲=毒蛇的轮舞曲
スラッシュ・ダイブ=俯冲斩
狼の戦爪=狼之战爪
ホルスブレード=荷鲁斯之剑
オーガ・ブロー=食人魔打击
ゴブリン王の威光=哥布林王的威望
オークぶち壊し=猪人大破坏
蜂蜜ホットケーキ=蜂蜜烤饼
トルネード・スピア=旋风疾刺
オーク武術の神髄=猪人武术的神髄
ネオ・インパクト=铁头冲击
ユニゾンプレッシャー=双子连携
キュプロ・ハンマー=巨人的铁锤
ガロードスナイプ=加洛特射击
ギガントスラッシュ=巨骑斩击
ダブルアイスハンマー=双重冰锤
致命の首狩り=致命的首狩
お前の物は我の物ニャ=你的东西是我的东西喵
ギガホーク=巨斧投掷
コボルド・グレイス=犬人的恩惠
ミルキー・シェル=贝壳之盾
邪狼の刃=邪狼之刃
ジェネラルアタック=上将攻击
サンダー・ストーム=雷电风暴
ライトウォール=光墙
パワー・クラッシュ=力量冲击
ダークネス・ブレイズ=暗黑烈焰
獅子王の喝采=狮子王的喝彩
エスペランザ=希望
フレイミング・ブロー=炎拳
魅惑の肉球=魅惑的肉球
メジェドオンステージ=梅杰德之光
海底女王の勅命=海底女王的敕命
ウジャトの風=乌吉特之风
フォールストリーム=飞瀑坠击
凶獣の連撃=凶兽的连击


——魔兽——
アント・イーター=食蚁攻击
水際の窮鼠=水边的穷鼠
毒ゲコーン=毒鸣
イオ・テンタクル=海妖之触手
ガルダダンス=加罗达舞
キャタピラダンス=毛毛虫舞
ロール・ユー=我想缠住你
ポイズン・テール=鸡鸣毒尾
イビル・アイ=邪眼
アイアン・ガード=钢铁防御
蜘蛛糸縛り=蜘蛛丝縛
毒炎ブレス=毒炎吐息
わんわんお=汪汪汪
クチバシ・レイド=鸟喙突击
アイスロック=冰锁
ベアナックル=熊拳
スパイク・カウンター=尖刺反击
ジュエル・ガード=宝石守御
スネイクファング=蛇牙
トリプル・バイト=三重咬杀
クイズアタック４２３=猜谜攻击 4 2 3
ポイズンブレス=剧毒吐息
発・天狼烈爪牙=发・天狼烈爪牙
ジュエル・コメット=宝石彗星
イエティ・パンチ=雪猿打击
邪悪の瞳=邪恶之瞳
侵略=侵略
飲みニケーション=饮酒交流
プリデイター=捕食者
怪樹テンタクルス=怪树触手
オブシダン・クロー=黑曜石爪
暴食の王=暴食之王
氷獣の咆哮=冰兽的咆哮
ブラッドクロ―=血爪
サンダーボルテックス=雷霆漩涡
サタナス・アイ=撒旦之眼
おなかへったー=肚子饿了
デュアルベノムテイル=双重毒尾
獣竜百叩き=兽龙百击
ストーン・ニードル=石针
触の後光=触之後光
触の呼び声=触手的呼喊
蝕の咆哮=蚀之咆哮
禁獣の凶爪=禁兽的凶爪
神鳥の加護=神鸟的加护
カースブラッドギアス=咒血戒律
灰燼滅流波=灰烬灭流波
冥獣咆哮=冥兽咆哮
呪いの狂牙=诅咒的狂牙
神獣防壁=神兽防壁
海神の怒り=海神之怒


——精灵——
水精の戯れ=水精灵的嬉戏
イタズラしちゃうぞ=要恶作剧了哦
マタンゴ・スポア=马探戈 毒孢子
幼艶の草ダンス=幼艳的草舞
ささやき戦術=耳语战术
霊薬ホーン=灵药之角
ぶっこぬきシャウト=猛拽哀嚎
バックスタッブ=背刺
オークスレイヤー=精灵剑术 兽人必死斩
タケノコ掘るゾ=挖竹笋
ポイズンショット=附毒射击
騒霊の演奏会=骚灵的演奏会
カクタス・ハグ!=仙人掌拥抱！
剣精の演舞=剑精的演舞
西風のプレリュード=西风的前奏曲
パライズ・スポア=剧毒孢子
樹霊のしずく=树灵之露
魅惑の草ダンス=魅惑的草舞
ガンズアンドブレード=枪剑二连击
ケンタウリ・スピア=人马枪刺
アイスウォール=冰墙
老練の盾=老练之盾
水霊の誘い=水灵的诱惑
オークバースト=精灵魔法 兽人必死炸裂
リーフ・シェイバー=绿叶剃刀
ヘヴィスイング=沉重挥舞
マッシュ・パスタ=蘑菇意大利面
聖女の一矢=圣女的一箭
ユニコフォース=独角蓄能
氷精の応援氷壁=冰精的应援冰壁
樹氷シールド=树冰盾
おしゃべ林檎=对话苹果
剣精の炎舞=剑精的炎舞
ケンタウリ・ランス=人马践踏
ぶっこみバリア=包含所有的屏障
精霊憑依=精霊凭依
エレメンタルウォール=精霊之壁
精霊入魂撃=精霊入魂击
ハグハグハグ=拥抱拥抱拥抱
セブンスソード=第七之剑
カブトガニシールド=马蹄蟹护盾
羊の擬態=羊的拟态
スイカ・ハレーション=西瓜眩光
エネルゲイア・カノン=新能加农炮
ドラッグ・ドラセナ=龙血树精华
ホワイトシード=白色种子
運命のカンパネルラ=命运的坎帕内拉
癒やしのお花畑=治愈花园
キングブレイブ=勇敢的国王
致死槍ゲイボルグ=致命枪盖尔格
妖精女王の加護=妖精女王的加护
不幸の鏡影=不幸的镜影
ブラックシード=黑色种子
影喰の一矢=影喰之一箭
覚醒・ドラセナリア=觉醒・龙血树
ききぃっ=萋萋
神樹の癒し=神树的治愈
月信の歌声=月信的歌声
ぎぎぃっ=蓟蓟
グランドクロス砲=大十字炮
月狂の歌声=月狂的歌声
屍蝕の霧=尸蚀之雾
樹竜プレス=树龙压迫
樹竜ストンプ=树龙践踏


——妖怪——
氷結晶=冰结晶
河童の川流し=河童的川流
狐火アタック=狐火攻击
ブリザード・クライ=吹雪
困った時の巫女頼み=麻烦时的巫女请求
空蝉の術・弐=空蝉之术・贰
ゆきやこんこん=雪之双子
招き猫パンチ=招财猫拳
極旨すまし汁=极品清汤
抜刀術・閃雷=拔刀术・闪雷
地獄ラーメン一丁=地狱拉面一份
大判小判の舞=大判小判的舞
王手飛車角金銀桂馬取=王手飞车角金银桂马取
捕縛術・地獄袈裟斬り=捕获术 地狱袈裟斩
抜刀術・閃雷=拔刀术・闪雷
天地裏返しの術=天地倒转之术
鬼の腕=鬼之腕
鬼娘に金棒=鬼娘挥金棒
狐流符術陣=狐流符术阵
狐火なのじゃ=这是狐火哦
疫病退散の瓦版=瘟疫溃散的瓦版
狂恨の呪怨=狂恨的咒怨
捕縛術・滅多矢鱈撃ち=捕缚术・灭多矢鱈击
恋文無双=情书无双
二尾ビンタ=二尾耳光
砂かけキック=扬沙踢
管狐三連星=管狐三连星
海壁=海壁
牛胆流・無双牛参り=牛胆流・无双牛参上
Ｋ・Ｓ・Ａ=Ｋ・Ｓ・Ａ
開けてビックリ玉手箱=打开后大惊的玉匣
氷結宝結晶=冰结宝结晶
撃滅仏恥義理=击灭佛耻义理
十字聖炎嵐=十字圣炎岚
神舞九輪破邪障壁=神舞九轮破邪屏障
豊穣の食卓=丰收的饭桌
酒呑棍棒真空撃=酒吞棍棒真空击
目貫の一槍=目贯的一枪
破邪の火焔=破邪的火焰
龍王裂波=龙王裂波
畏怖蓮華刃=畏怖莲华刃
一緒に遊びましょ=一起玩吧 
バスターオブアスラ=阿修罗爆裂
山崩し=山崩
天羽々斬=天羽羽斩
神威蛇龍破=神威蛇龙破
黄泉比良坂=黄泉比良坂


——恶魔——
イタズラ・クライム=恶作剧犯罪
ゴールデビルハンマー=挥金如土
農奴の逆襲=农奴的逆袭
ライフスティール=生命偷取
天使の治療=天使的治疗
石化にらみ=石化
食撃のトーフ=食撃之豆腐
汚物は消毒だぁ=除污消毒
メリーの子守歌=玛丽的摇篮曲
砲撃支援要請=请求炮击支援
悪戯小悪魔=恶戏小恶魔
発情フェロモン=发情费洛蒙
発情邪眼=发情邪眼
ブラッドソード=血剑
マジックレイ=魔法之雨
オプティックシールド=幻光盾
酔拳・ツボ押しの舞=醉拳・点穴之舞
究極の上魔刺定食=终极上魔刺身套餐
デッドリー点滴=救死点滴
ハピネスメリー=快乐幸福
斬り刻みオペ=切碎手术
スキルブレイク=技能破解
至高の魔懐石料理=至高的魔怀石料理
ジャッジメント=审判
ブリザードストーム=暴风雪
ライトニング・レイ=闪电射线
汚物は滅菌だぁ=除污灭菌
デーモン鉄球=恶魔铁球
論理の唄=理论之歌
淫婦の抱擁=淫妇的拥抱
ソウルスティール=灵魂偷取
輪廻の蛇精=轮回的蛇精
魔炎の宴=魔炎之宴
魔槍三叉戟=魔枪三叉戟
アルマゲドンロック=末日摇滚
シークレットタブー=窥密之禁
船盛大盤振る舞い=船之盛宴挥舞
ブラックスター=黑星
ロイヤルフラッシュ=皇家同花顺
食神流三枚卸し=食神流三鱼片
ブレイブストーム=勇气风暴
武装転成=武装转成
魔猿解放=魔猿解放
漆黒の槍=漆黑之枪
マモン・ロワイヤル=皇家玛门
メフィストの嘘=梅菲斯特的谎言
イビル・スティング=邪恶之刺
闇の明星=暗之明星
ストームディバイダー=风暴隔断
獣魔焦熱嵐=兽魔焦热岚
イラ=怒


——不死——
ティーカップ乱れ打ち=茶杯乱打
ゴーストアタック=幽灵攻击
骸骨剣・サミダレ=骷髅剑・五月雨
叫喚=呼唤
グルルン・クロー=咕噜噜之爪
包帯ヒール=绷带治疗
恨骸の呪撃=恨骸的咒击
骸骨剣・ジュオン=骷髅剑・咒怨
デッドリースキン=死肤
ゾンビ定食弁当…デス=僵尸套餐便当…的说
シャドウ・スタッブ=暗夜袭杀
骸骨槍・無骨三段=骷髅枪・无骨三段
デスハリケーンでちっ=死亡飓风
死の夜泣き=死之夜哭
悲恋の記憶=悲恋的记忆
サンクチュアリ=圣所
アシッド・ファング=酸性爪击
ブラッドチャージ=浴血充能
粉骨爆散拳=粉骨爆散拳
ＤＷＰアタック=DWP攻击
ソウルキック=魂蹴
ダークネスホーリー=暗光
トリックオアトリート=诡计四重奏
人喰い乱舞=食人狂舞
スカルバースト=尸爆术
トリプルセイバー=三重剑技
デスハッグ=死亡拥抱
膝骨突進=膝骨突进
ゴーストミスト=幽灵雾
不死者の祝宴=不死者的庆宴
呪怨・血塗られの御霊=咒怨・血染的御灵
死装解放・魂魄葬送=死装解放・魂魄葬送
千客万来=千客万来
呪いの単眼=诅咒的单眼
吸血エロティシズム=吸血狂欢
怨念の血刀=怨念的血刀
デスアサルト=死亡突击
死者の魔弾=死者的魔弹
GUGAAAAA=GUGAAAAA
リトル・リトル・ヘル=小小地狱
竜骨女の呪い=龙骨女的诅咒
亡者楽園=亡者乐园
ヴァンプドレイン=血流成河
竜殺衝=龙杀冲
亡者船団=亡者船队
亡者の舞踏会=亡者的舞会
ホーンテッドダンス=招魂之舞
死装解放・神魔殲葬=死装解放・神魔歼葬
幽爆魔弾=幽爆魔弹
骨竜コンビネーション=骨龙连携
ハイ＝ダラー=啊！打
腐敗のブレス=腐败吐息
煉獄祐筆=炼狱佑笔
グラッジヒール=怨恨之踵
シー・イーター=食海者
罪人処断=罪人处决
冥軍号令=冥军号令
冥府魂殺=冥府魂杀
冥界六法=冥界六法
冥府獄壁=冥府狱壁
冥界の哲理=冥界的哲理
獄鬼壊乱=狱鬼坏乱
踝骨の衝撃=踝骨的冲击
呪怨の剣舞=咒怨的剑舞
骨塊防壁=骨块防壁
地獄満願全席=地狱满汉全席
虚無の断刃=虚无的断刃
虚無の軍令=虚无的军令
虚無の連殺=虚无的连杀
虚無の破法=虚无的破法
虚無の獄壁=虚无的狱壁
虚無の哲理=虚无的哲理
虚無壊乱=虚无坏乱
死葬詠唱・夢幻散華=死葬咏唱・梦幻散华
竜骸暴威=龙骸暴威
冥界姫の笑み=冥界姬的笑容

——造魔——
スライムアタック=史莱姆攻击
ヤンスビーム=哎呀光束
石体落とし=石体抛落
プラグショック=插头冲击
エーテリア・ヒール=以太治愈术
スライム鉄砲=史莱姆铁炮
炎と氷の賭場=炎与冰的赌场
不意打ちガブリ=不意打
ロツクバスター=岩石克星
ストーンウォール=石壁
ガーネット・フォウム=宝石护盾
岩内股=岩内股
ブラッドスクライド=鲜血枪刺
ロックオンスナイプ=锁定狙击
シャットアウトガード=隔绝之壁
ヘヴィ・ナックル=沉重拳击
小人の迷宮保善活動=小人的迷宫保善活动
ライツセイバー=光剑
キラキラボンバー=闪耀闪耀炸弹
ブレイブアサルト=勇气突击
マリオネットダンス=木偶舞蹈
氷大外刈=冰大外刈
拘束ナブリ=拘束三角切割
ビットバリア=浮游防护罩
勇者の嫁=勇者的新娘
ロケット・ランチャー=火箭弹幕
スリーストライク=女仆流三连击
レイスフィールド=灵想领域
迎撃モード移行=迎击模式转移
プロテクトバリア=保护屏障
惨殺剣=惨杀剑
ライジング・デュエル=骑乘决斗
ひんぬープレス=贫乳压迫
レイスバレット=灵想飞弹
ネックブリーカーボム=碎颈炸弹
ブレイクブレード=破甲斩
スプラッシュパンチ=溅射拳
クッキングスタート=烹饪开始
スライム爆弾=史莱姆炸弹
ウォールプレス=壁压
エアスライド=空气滑梯
フォージナイフ=造天使之刃
ファーミング・デイ=农忙日
スキャニングコール=扫描解析
パーフェクトコマンド=完美指令
ケチャップドバドバ=番茄酱滴答滴答
強欲なる怒り=贪婪的愤怒
ドラゴニックギア=龙之齿轮
オーバーダイブ=俯冲
ＳＳパンチ=SS冲击
タイタニックビート=巨龙震地
惨殺乱舞剣=惨杀乱舞剑
ミリオン・ミザリィー=百万灾厄
パワースラッシュ=力量斩
スウィートホーム=甜蜜的家
ウルティマコマンド=终极指令
防衛システム起動=防卫系统启动
造天使の償い=造天使的赎罪
フォージガルガル=造天使的战车
フォージ・プロトコル=造天使的协议
エネルゲイア=可能性防护
イグニション・レイ=点火・光
事象改変=事象改変
天叢雲剣=天丛云剑
キラキラバーン=闪耀闪耀砰
ファルスナイフ=虚数之刃
ファルスガルガル=虚数战车
虚構の償い=虚构的赎罪
ファルス・プロトコル=虚数协议
エンテレケイア=完美的防护
イグニション・ダーク=点火・暗
次元改変=次元改变
アルカイックバースト=上古歼灭炮



——龙族——
ミニファイア=迷你火焰
地竜疾駆=地龙疾驰
竜風船体当たり=龙气球冲撞
滑空槍撃=滑空枪击
ウイングマジック=魔法之翼
サーペントブレス=海蛇吐息
ファイアストーム=火焰风暴
ドラゴンマーチ=龙之进行曲
ドラゴンソニック=龙之音速
サモン・ドラゴン=召龙术
マグマブレス=岩浆吐息
ドラゴンブロッカー=龙之防阵
ドラゴンズロック=龙之行军
翼竜爪=翼龙爪
太陽の満漢全席=太阳的满汉全席
アクアクロー=水龙爪
火竜爪=火龙爪
ドラゴンダイブ=龙之俯冲
ガストブレス=毒息
シャドウイーター=阴影吞噬
ハイスラァ=跃斩
ホークアサルト=翔鹰突袭
ファイアーブレス=烈焰吐息
竜神楽=龙神乐
桜花斬刃=樱花斩刃
フェザーアロー=羽箭射击
ウィンドブラスト=风爆
アーマーガード=装甲守护
 空蝉影分身の術=空蝉影分身之术
殲滅陣形・天の型=歼灭阵形・天之型
射貫き=射贯
岩竜ガード=岩龙守御
竜弦の響き=龙弦的响声
ミーミスブルン=密米尔之泉
竜血再生=龙血再生
竜水晶の輝き=龙水晶之辉
銀の竜風=银之龙风
アイスストーム=冰淇淋风暴
冥道霊符陣=冥道灵符阵
ケミカルパライズ=炼金药剂
金の竜爪=金之龙爪
アクアブレス=深水吐息
ファイアブレス=炼狱吐息
ストームスラッシュ=暴风斩击
アースランス=大地之矛
アビスロア=深渊噬牙
清廉なる祈り=清廉的祈祷
早駆け=疾驰
ソウルハウル=灵魂嚎叫
ドラゴンクロス=龙之十字
エクスキューション=处刑
パニッシュメント=惩罚
絶対零度ブレス=绝对零度吐息
腐毒ブレス=腐毒吐息
アビッサル・バイト=噬魂地狱
エスピリト・カノン=灵能加农炮
竜炎業火=龙炎业火
竜将軍の叱咤=龙将军的叱咤
宝玉の輝き=宝玉的光辉
母性解放=母性解放
ブラッドクロウ=血腥龙爪击
豊穣の大雨=丰收的大雨
インフィニティ=无限
ビッグバン・カノン=大爆炸加农炮
覇竜氷結流=霸龙冰结流


——虫族——
テンタロックル=触手束缚
ころころタックル=转圈圈突进
今日も一日頑張るビー=今天一天也要加油蜂
嫌な羽音=讨厌的羽音
巻き付く=缠绕
挟む=夹
変な踊り=奇怪的舞蹈
カチナの笛=卡奇纳之笛
ブレインイーター=食脑者
テンタロンリネス=触之孤独
噛みつく=撕咬
地獄へご招待=地狱招待
触手医療=触手医疗
体当たり=猛撞
アシッド・ピアース=酸蚀刺击
水鉄砲=水炮
加速する=加速
不快な羽音=不愉快的羽音
私の為に働きなさい=去给我拼死工作
ブレインクラッシュ=脑破坏
挟み砕く=捏碎
テンタティータイム=下午茶时间
不思議な踊り=不可思议的舞蹈
パラサイトス=寄生
ふみつけ=践踏
激しく巻き付く=激烈地缠绕
竜族捕食=龙族捕食
ビョルビョルしますわ=全都变得黏糊糊的吧
ニュルンベルクシルト=纽伦堡之盾
全力体当たり=全力猛撞
迷宮クリーニング=迷宫清洗
テンタロマンチスト=触之浪漫
食らいつく=吃
ブレインポイズン=脑毒
竜族毒化捕食=龙族毒化捕食
きゃはははは――っ=洽哈哈哈哈――
テンタミソロジー=触之神话
噛み千切る=咬碎
アトラク＝ナクア=深渊之网
捕食=捕食
パラサイトブレイド=寄生之刃
パラサイトバレッド=寄生支配
永遠を喰らう口=永喰之口
玉鋼の甲殻=玉钢的甲壳
Lv3 玉鋼の甲殻=Lv3 玉钢的甲壳
ワタシの生け贄=做我的祭品


——人类——
ラピッドアロー=急速箭矢
ケミカルアンカー=化学锚
カチ割り=劈成两半
気合の一撃=气势的一击
いざ参る=参上
一斉斉射=齐射
スピードショット=速射
馬上弓の一撃=马上弓的一击
空蝉の術・壱=空蝉之术・壹
シルバーショット=银弹
盾兵ド根性・最終回=盾兵根性・最终回
ポーションパラダイス=药水天堂
オンバサラ=百字明咒
正々堂々斬=堂堂正正地斩杀
アサルトラッシュ=爆炸性冲击
リーズンラッシュ=理性冲锋
邪道槍術=邪道枪术
隠密工作=隐秘工作
破壊工作=破坏工作
チェインマジック=锁链魔法
ポイズンスモッグ=剧毒烟雾
呪っちゃうぞー=诅咒你哦
略奪ヒャッハー=劫掠嘿呀哈
槍兵突撃攻撃=枪兵突击攻击
槍兵迎撃態勢=枪兵迎击态势
ダイヤモンドカッター=钻石切割
神への祈り=对神明祈祷
ひき逃げバスター=战车碾压
追い剥ぎサーベル=打劫佩刀
密林戦法・突=密林战法・突
人狼一体・黒雷撃=人狼一体・黑雷击
ロングレンジショット=远距离射击
しくじるんじゃないよ=别搞砸了
ハイディングブロー=隐密打击
ポーション乱舞・毒=药水乱舞・毒
大泥棒参上=大盗贼参上
密林戦法・斬=密林战法・斩
レッツパーリー=派对时间
ゴーグリフォン=冲吧狮鹫
ゲイルブレイド=风之剑
身の程をわきまえよ=要懂得分寸
密林戦法・射=密林战法・射
シルバーマシンガン=银机关枪
星読みの加護=星读的加护
式神ナックル=式神之拳
エレメンタルパワー=精灵之力
密林戦法・魔=密林战法・魔
男の防御=男人的防御
アイアンウォール=钢铁墙
グランドクロス=大十字
ドラゴンガード=龙之防御
私の右手は神の拳=我的右手是神之拳
お宝よこしな=把宝物交出来
神からの奇跡=来自神的奇迹
キャッチ＆スラッシュ=捉&斩
武士突撃=武士突击
飛竜の咆吼=飞龙的咆哮
癒やしの星光=治愈的星光
カウンターガード=反击防御
クリスタルガード=水晶护罩
克己の肉体=克己的肉体
チャージングスピア=龙枪冲刺
ドラゴンブレス=龙之吐息 
セイント・バリア=神术屏障
セイント・クラッシュ=神术冲击
ヴェノムナイフ=剧毒刀
パライズクロ―=麻痹爪
密林戦技・レパード=密林战技・豹
ペガススの乙女=飞马座的少女
毒房の紫槍=毒房的紫枪
血煙防戦陣=血烟防战阵
ロードシールド=路障
暗殺狙撃=暗杀狙击
近衛排除=近卫排除
ハルモニアの盾=和谐之盾
二刀流・鬼斬=二刀流・鬼斩
二刀流・鬼灯=二刀流・鬼灯
剣武・札舞=剑武・札舞
仙術・荒御魂=仙术・荒御魂
心が踊るぜ=舞动之心
楽しませな=取悦我吧
山砕き=山碎
秘技・竜舞拳=秘技・竜舞拳
天空の撃墜王=天空的击坠王
人竜一体=人龙一体
おお、我らが主よ=啊，我们的主啊
火球ボンバー=火球轰炸
叡智を授けよう=传授智慧吧
呪符術式展開=咒符术式展开
バリスタ狙撃=弩炮狙击
ストレス発散=炮击释放
聖域大結界=圣域大结界
ネメシス・クロス=复仇十字
合戦大号令=合战大号令
オリファンの笛=猎户座的笛子
救いの祈りよ=救赎的祈祷
ブラックウォール=黑墙
古の禁術=古之禁术
戦士の進軍=战士的进军
ブルーフレイム=幽蓝魔焰
破導拳=破导拳
エネルギーフィールド=能量场域
エネルギーシールド=能量护盾
ゴールドウォール=金墙
アルティメットカノン=究极加农炮
明王ラッシュ=明王突进
カオスクライムカノン=混沌罪恶加农炮
ファイナル流し斬り=最终流斩


——神族——
戦の聖歌=战之圣歌
聖なる癒やし=圣灵的治愈
戦乙女の剣旋=战少女的剑旋
キュン、キューン=嘁呦嘁呦
戦士の槍=战士的枪
勇者の槍=勇士之枪
ツインセイバー=双剑
ダブルセイバー=二重剑
ピアッシング=圣枪穿刺
ペネトレイション=圣枪渗透
雷精放電=雷精放电
冥獄の歌=冥狱之歌
天輪の歌=天轮之歌
天使の癒やし=天使的治愈
戦士の旋律=战士的旋律
天使のおもてなし=天使的款待
ダークソード=暗剑
ホーリーソード=神圣之剑
神馬突撃=神马突击
エンジェル・ガード=圣天之御
フォールン・ガード=堕天之御
太陽の奇跡=太阳的奇迹
雷撃雨=雷击雨
再生の炎=再生之炎
聖獣の爪=圣兽之爪
聖なる護甲=圣灵护甲
ヴァーハナ=瓦哈纳
零の秘術=零之秘术
無慈悲な一刀=无慈悲的一刀
虚構の防壁=虚构的防壁
星天の矢雨=星天箭雨
邪竜斬破=邪龙斩破
サンダーレイド=雷霆突袭
究極魔法・アルタール=终极魔法・阿尔塔
大地の恵み=大地的恩惠
堕落の霊光=堕落的灵光
使徒の霊光=使徒的灵光
ルナティックバニシュ=狂妄断罪
クロス・バニシュ=十字断罪
神獣雷閃=神兽雷闪
勝利を導く神糸=引导胜利的神线
福音の雷=福音之雷
福音の火砲=福音的火炮
福音の氷雪=福音的冰雪
福音の聖壁=福音的圣壁
福音の慈雨=福音的慈雨
幸運の牙筆=幸运的牙笔
神槍アンティオキア=神枪安提奥基亚
神焔斬=神焰斩
神霊風=神灵风
神鎧甲=神铠甲
神水恵=神水惠
断罪の炎槍=断罪的炎枪
天渦竜雷=天涡龙雷
セファー・ラジエール=神光普照
天使の寵愛=天使的宠爱
神鍵の聖域=神鍵的圣域
魂喰らい=魂喰
心無き斬舞=心无斩舞
月光医療=月光医疗
クラッシュ・レイ=崩灭神雷
ラヴ・ビーム=爱的光束
楽園のフルコース=乐园的全餐
天罰の劫火砲=天罚之劫火炮
天罰の大洪水=天罚之大洪水
天罰の氷雪嵐=天罚之冰雪岚
天罰の神隔壁=天罚之神隔壁
天罰の轟雷=天罚之轰雷
海神雷戟=海神雷戟
天神大轟斧=天神大轰斧
裁きの業火=裁决之业火
黒龍弾=黑龙弹
風舞・天裂風=风舞・天裂风
シャルヴ=沙尔瓦
死と破壊の舞踊=死亡与破坏之舞


——混沌——
呪いの林檎=诅咒苹果
混沌の再生=混沌的再生
呪いの裂創=诅咒的裂创
混沌魔術=混沌魔术
凍て付く世界=冻结世界
混沌斬撃=混沌斩击
古の波動=古之波动
歪みの皮甲=歪斜的皮面
無貌の祈り=无面的祈祷
狂喜=狂喜
悲観の涙=悲观之泪
慈愛の蓮=慈爱之莲
安楽の笑み=安乐的笑容
憤怒の衝撃=愤怒的冲击
屍神の呪痕=尸神的咒痕
嵐神の風舞=岚神的风舞
炎神の暴食=炎神的暴食
海神の咆哮=海神的咆哮
血涙のヴァルキュリア=血泪之女武神
血涙の呪毒=血泪之咒毒
血涙の毒拳=血泪之毒拳
血涙の毒槍=血泪之毒枪
血涙の凶霧=血泪之凶雾
血涙の毒雷=血泪之毒雷
狂乱の進軍=狂乱的进军
怨喜=怨喜
怨愛の蓮=怨爱之莲
怨悲の涙=怨悲之泪
怨楽の笑み=怨乐的笑容
怨怒の衝撃=怨怒的冲击
同化性フェノメノン=同化性现象
捕食性フェノメノン=捕食性现象
硬化性フェノメノン=硬化性现象
癒合性フェノメノン=联合性现象
怨血斬破=怨血斩破
オルクスサンダー=愤恨惊雷
慟哭の矢雨=恸哭矢雨
呪殺魔法トイフェル=咒杀魔法特伊费尔
災厄の槍=灾祸之枪
災厄の杖=灾祸之杖
災厄の盾=灾祸之盾
災厄の鎧=灾祸之铠
災厄の大鎌=灾祸的大镰
災厄の大剣=灾祸的大剑
災厄の大砲=灾祸的大炮
災厄の魔術書=灾祸的魔法书
侵略性フェノメノン=侵略性现象
統一性フェノメノン=统一性现象
剛体性フェノメノン=刚体性现象
再生性フェノメノン=再生性现象
影竜の城壁=影龙的城壁
シャドウ・バイト=阴影之噬
恐敗のブレス=恐怖吐息
覇竜恐影波=霸龙恐影波
混沌の聖域=混沌的圣域
呪槍アンティオキア=咒枪安提奥基亚
混沌より出でるモノ=混沌之物

サタナス光線=灭尽光线
ウルティマ光線=终极光线
ディバイン光線=极圣光线
万色光線=万色光线

——英雄——
ブラック・バーン=黑炎
黒の契印=黑之契印

闇の王レギウス=暗之王 雷吉乌斯
ダーク・ブレイズ=暗之炽焰
ダーク・サーバント=暗之从者
ブラッド・セイバー=血屠皇斩
蝕の契印=蚀之契印
エクリプス=日蚀湮击

アリシアの加護=真理的加护
月光のイストリア=月光的史话

覚醒イシュタル=觉醒 伊什塔尔
真紅のセラピア=真红的治疗法
月神のイストリア=月神的史话
アリシアの賢世=真理的贤世
黄金のプロメテイオン=黄金的灵血药
創生のエレフセリア=创生的自由

聖狼牙=圣狼牙
シリウスの眼=天狼星之眼
覚醒アーシェラ=觉醒 阿榭菈
劫火槌=劫火槌
神狼牙=神狼牙
シリウスの神眼=天狼星之神眼

悪アーシェラ=恶 阿榭菈
劫火殲滅陣=劫火歼灭阵
天魔狼爪=天魔狼爪
シリウスの魔眼=天狼星之魔眼
獄炎の守護者=狱炎的守护者
獄焔葬=狱焰葬

幻影光弾=幻影光弹

悪ミスタリア=恶 米斯塔莉娅
精霊惨劇=精霊惨剧
ブラッドベリ=血浆果
暗黒樹の磔刑=暗黑树之磔刑
毒薔薇の棘=毒蔷薇之棘

覚醒ミスタリア=觉醒 米斯塔莉娅
夢幻華弾=梦幻华弹
セフィロート=生命之树
精霊音階=精霊音阶
メテオリート=陨石
ユグドラシル=世界树

覚醒トゥリン=觉醒 荼琳
エレメント・アロー=精霊之箭
ライトニング・レイ=雷霆爆射
ハンターズ・サイト=狩猎场
波状流星弾=波状流星弹
ウラノ・マキナ=魔导天殛

神鏡結界・天津甕星=神镜结界・天津瓮星
悪ヒミカ=恶 绯弥香
鏡面結界・刃凶=镜面结界・刃凶
黒天縛縄=黑天缚绳
邪鏡結界・天岩戸=邪镜结界・天岩户
大呪法・紅蓮転生=大咒法・红莲转生
反鏡・曼荼羅=反镜・曼荼罗

覚醒ヒミカ=觉醒 绯弥香
鏡面結界・刃桜=镜面结界・刃樱
聖光縛縄=圣光缚绳
死返玉鏡=死返玉镜
大呪法・日輪天照=大咒法・日轮天照
神鏡結界・天津甕星改=神镜结界・天津瓮星改

覚醒イザヨイ=觉醒 十六夜
影縛りの術=影缚之术
秘刃・影野薔薇=秘刃・影野蔷薇
霊獣招来=灵兽招来
秘刃・凍雲=秘刃・冻云
式人一体・霊獣憑依=式人一体・灵兽凭依

覚醒リンリン=觉醒 淋淋
リンリンブレード=淋淋之刃
ドロドロシャワー=黏黏淋浴
リンリンシールド=淋淋护罩
分身リンリン合体=分身淋淋合体
スーパーリンリン乱舞=超级淋淋乱舞

宝石獣召喚=宝石兽召唤
覚醒ルーリエ=觉醒 露莉艾
プリズム・ライト=棱镜之光
小さき斥候=小小斥候
宝石竜召喚=宝石龙召唤
愛情料理=爱情料理
プリズム・プレイア=棱镜祝福

覚醒アリス=觉醒 爱丽丝
フレイム・バレット=火焰弹
暗月の癒し=暗月的治愈
真紅の涙雨=真红的泪雨
ダーク・ボルト=暗黑的弩箭
暗月の福音=暗月的福音

覚醒イーニア=觉醒 伊妮娅
レイジング・クロー=怒龙爪
ドラゴン・ブリッツ=龙之闪袭
竜麗舞踊=龙丽舞踊
バースト・ロア=爆烈龙吼
竜爪乱舞イストミア=龙爪乱舞

狂王ラミリアーク=狂王 拉米利亚克
ツイスター・バイト=飓风之噬
ディザスター・ブレス=灾难吐息
狂乱の雷鳴=狂乱雷鸣
世界を震わす雷鳴=震世雷鸣


ジルディス
チェイン・スパーク=连锁闪电
ストーン・ウォール=岩石防壁
帯電する竜爪=带电龙爪
群竜招来=群龙招来
ハリケーン・バースト=飓风爆发

洗礼ジルディス
討魔の竜爪=讨魔龙爪 
光翼輝天=光翼辉天
ホーリー・ウォール=神圣防壁
ホーリー・バースト=神圣冲击

勇者テリオン=勇者 特里昂
ハード・スラッシュ=强力斩
極聖の鼓舞=极圣的鼓舞
ソウルイーター=灵魂吞噬者
ディバイン・ブレイド=极圣斩
エクスティンクション=绝灭斩

暴走テリオン=暴走 特里昂
強撃=强击
極聖の凶剣=极圣的凶剑
極聖暴走=极圣暴走

冥神エレシュキガル=冥神 埃列什基伽尔
邪神エレシュキガル=邪神 埃列什基伽尔
冥府叫嵐=冥府叫岚
ディスペア・シャドウ=绝望之影
魂魄流転=魂魄流转
グラガンナの屍炎=古加兰那的尸炎
クルヌギア=冥狱

冥界の巫女エリシャ=冥界的巫女 埃莉莎
冥府の風=冥府之风
ネクタールの雫=甘露之滴
クルの法典=冥府的法典
記憶に沈む眠り=于回忆中沉眠
アルラートの悲嘆=阿尔拉特的悲叹

冥神の依代エリシャ=冥神的依代 埃莉莎
デス・グレイヴ=死亡之墓
クルの大法典=冥府大法典
フィーブルの氾濫=衰朽的糜烂
アルラートの厄災=阿尔拉特的厄灾

冥神の剣ネルガル=冥神之剑 内尔伽尔
テラー・グラウンド=绝地
デス・ストリーク=死线
アビサル・センス=冥觉
ソウル・クラッシュ=魂崩
ソウル・ブレイカー=魂破

漆黒の勇者エンキドゥ=漆黑的勇者 恩奇都
ブレイド・ストーム=剑刃风暴
エンカレッジメント=鼓舞
ゴッド・センス=神觉

深淵の蜘蛛アラネア=深渊的蜘蛛 阿拉尼娅
アラクネ・スレッド=蛛网术
ケイオス・スレッド=混沌蛛网
ケイオス・エフェクト=混沌效应
宵闇のエリクシール=宵暗的灵药

柳城正景
疾風撃剣=疾风击剑
抜刀術・飛蓮=拔刀术・飞莲
極技・戦嵐武剄=极技・战岚武刭

亡者正景
血風撃剣=血风击剑
抜刀術・死風=拔刀术・死风
致命技・凶嵐武剄=致命技・凶岚武刭

クナ
清めの命水=清澈的命水
破魔護風陣=破魔护风阵
巫術・龍水波濤=巫术・龙水波涛

骸巫女クナ=骸巫女库娜
黄泉の死水=黄泉的死水
魑魅魍魎之宴=魑魅魍魉之宴
屍術・黄泉醜女=尸术・黄泉丑女

五条久良
裂帛鬼剣=裂帛鬼剑
鬼気発翔=鬼气发翔
闘鬼滅世撃=斗鬼灭世击

阿久罗王
死凶鬼剣=死凶鬼剑
死凶裂破=死凶裂破
死凶災禍撃=死凶祸击

バース
クリスタル・ライト=水晶之光
水晶竜召喚=水晶龙召唤
アルケミック・バーン=炼金灼炎

亡者バース=亡者 巴斯
ダーティ・ライト=污秽之光
邪晶竜召喚=邪晶龙召唤
亡者の焦熱=亡者的焦热

マクヴァーン
エレメンタル・ソード=精霊之剑
ツリー・シュラウド=树罩
ステラ・ストリーム=星流

不死者マクヴァーン=不死者马库文
カースド・セイバー=诅咒之剑
ロトン・クラウド=尸云
フォーリング・スター=陨星

プリシラ
ヴォーパル・スライス=沃帕斩击
ビースト・レイジ=野性之怒
ヴォーパル・クロス=沃帕十字

玛娜
勇壮のマーチ=勇壮进行曲
慟哭のエレジー=恸哭的哀歌
楽園の為のカンタータ=乐园大合唱

ハリアル
慈愛の光=慈爱之光
ゴッド・リブラ=女神天秤
福音の光翼=福音的光翼
黄金のサンクチュアリ=黄金的圣殿
太陽創生=太阳创生

太陽神ハリアル=太陽神 哈利艾尔

天使長アルカーラ=天使長 阿尔卡拉
ホーリー・レイ=圣光
ホーリー・ワード=圣域
シヴィル・スティグマ=天仆之痕
ゴッド・ジャベリン=神之标枪
ヘヴン・パニッシュ=天罚

母神アルカーラ=母神 阿尔卡拉
エンシェント・レイ=远古之光
声なき対話=无声对话
ライフ・スティグマ=生命之痕
アーキアン・レイン=阿基安之雨
マザー・レゾナンス=母体共鸣

马尔达克
縛鎖の断罪=缚锁的断罪
巨神像の剛拳=巨神像的刚拳
爆神怒号=爆神怒号

狼神
紅蓮天狼爪=红莲天狼爪
焦熱波=焦热波
魂魄灰燼衝=魂魄灰烬冲

星神
星羽刃=星羽刃
爛熟の瘴気=烂熟的瘴气
流星の神翼=流星之神翼

海神
深き大渦=深海大涡
禍の大津波=祸之大海啸
海神の大嵐=海神的大岚

蚀龙
影竜爪=影龙爪
影竜咆哮=影龙咆哮
恐影幻像=恐影幻像
魂魄飽食=魂魄饱食
終焉の霊禍=终焉的灵祸

阿基安
終局性フェノメノン=终局性现象
再臨性フェノメノン=再临性现象
崩壊性フェノメノン=崩坏性现象

邪神ニンフルサグ=邪神 宁胡尔萨格
混沌の芽=混沌之芽
断命剣=断命剑
使徒の楔=使徒之楔
次元層乖離=次元层乖离
進化と破滅の火=进化与破灭之火

库托
ツイスト・ブレット=扭曲子弹
マルチエレメント=多重元素
ファナティック・アイ=狂信之眼
乖離双聖=乖离双圣

露琪娜
ジェニ・アルージェ=太阳之剑
ルナ・アムリェート=月之加护
アグニ=火神之焰
ソーラ・メテオリート=太阳陨落
トロイエ・ヴァルナ=三重魔爆

卡妮朵
エアレイド=空袭
スティンガーベル=刺铃
ジャベリン=标枪
フェザーコート=羽衣
グラーシーザ=格拉西萨

莎拉琪亚
メディカ=包扎
ヴェノム=毒液
メディクス=医疗
アクア=水
メイル・シュトロム=大漩涡

莉莉西亚
リリシア仁王立ち=莉莉西亚仁王立
リリシアスマッシュ=莉莉西亚粉碎
リリシア乱れ撃ち=莉莉西亚乱击
リリシアヒーリング=莉莉西亚治愈
リリシアサモン=莉莉西亚召唤

桔梗
鬼式・攻めの一手=鬼式・攻之一手
鬼式・耐えの一手=鬼式・耐之一手
冥閃・六文連斬=冥闪・六文连斩
黄泉送りの舞=黄泉相送之舞
剛斬術・獅子神楽=刚斩术・狮子神乐

塞蕾娜
ハイレン=治愈
リヒト・シュトース=闪光突刺
シルトグランツ=恒光之壁
グロス・ハイレン=救赎众生
光竜の息吹=光龙的息吹

弗洛尔希亚
ベリサルダストライク=魔剑打击
竜笛・炎の鼓動=龙笛・炎之鼓动
デモンバルディッシュ=恶魔战斧
グローリー・ブレイブ=荣耀勇者
ゲヘナ・ドライグ=地狱之龙

普利马蒂斯
陣形指示・鶴翼=阵形指示・鹤翼
隠密機動=隐密机动
カースブレイド=诅咒之刃
攻撃指示・一斉射撃=攻击指示・齐射
陣形指示・偃月=阵形指示・偃月

莎娜
ヴァダー・クルィーク=水之牙
流氷演舞=流冰演舞
剣舞・氷鏡=剑舞・冰镜
冷凍血華=冷冻血华
竜眼・刹那ノ見切り=龙眼・刹那的见切

阿基利斯
ヴァイナー=战争宣告
我流・唯牙独存=我流・唯牙独存
ラーヴァ=熔流
ディクタトゥーラ=专政
クレマツィア=黩武

莎莉亚
太陽を潰す右脚=溃日右脚
月を砕く左脚=碎月左脚
竜を討つ右腕=屠龙右臂
杯を掲げる左腕=举杯左臂
全知全能の眼=全知全能之眼

米利亚
翔竜光破=翔龙光破
翔竜焔舞=翔龙焰舞
聖騎士の盾=圣骑士之盾
輝竜光爆閃=辉龙光爆闪
天竜車旋斬=天龙车旋斩

巴
えれきてる･りたーん=电击复苏
ぷりてぃ･ぷりずん=可爱囚牢
ぷりずむ･ぷらねっと=棱镜星球
みらくる･りすたーと=奇迹再生
はっぴーないんてーる=快乐九尾

みらくる・りすたーと=奇迹再生
ぷりずむ・ぷらねっと=棱镜星球
ぷりてぃ・ぷりずん=可爱囚牢
えれきてる・りたーん=电击复苏


库库鲁
ウィンドスプラッシュ=风溅
ラッキークローバー=幸运草
ワールウィンド=旋风
サイクロンジャック=气旋抬升
スピリットラバー=劫魂者

玛丽
旋転潮=回旋潮
鋼水弾=钢水弹
幻蛇流戦波=幻蛇流战波
海竜特攻=海龙特攻
黄金船団=黄金船队

卡米拉
血の輪舞曲=血之轮舞曲
暗黒星の大門=暗黑星的大门
悪魔の慈悲=恶魔的慈悲
超重力召破=超重力召唤
紅焔の嵐=红焰之岚

爱狄丽雅
アグリゲートフェイス=正面集合
ヘヴンズ・ディクリー=天之法令
ディヴァイン・ナイツ=神圣骑士
浄化の雷=净化之雷
セイクリッドセブン=神圣之七

恶之露托娜
天雷=天雷
天命=天命
クルセイダー=十字军
ケリュケイオン=天命之杖

菲蕾斯
影の狩り手=影之狩猎
黒死病=黑死病
影の路=影之路
シャドウ・トーメント=影之折磨
クロノス=克罗诺斯

恶之佩尔塞拉
火剣の舞=火剑之舞
フレアバースト=爆裂火焰
レッドアヴェンジャー=红色复仇者
ファフニールの火=法夫尼尔之火
レーヴァテイン=雷瓦汀

恶之卡萨露娜
癒しの水=治愈之水
リバー・アシスタンス=河流援助
グレイス・レイン=恩惠之雨
タイダルウェイブ=潮汐奔涌
トリアイナ=特里亚纳

恶之尤狄尔
ラピッドアクション=快速行动
トルネード=龙卷风
グリッダ・サジタリス=闪耀射手座
風神壁=风神壁
ギャラルホルン=加拉尔号角

恶之克罗菲亚
大地の守護=大地的守护
クラック=裂缝
グランド・ルーク=大地堡垒
アイアン・メイデン=铁处女
アトラス=阿特拉斯

皇帝弗利多
黒神雷=黑神雷
大洪水=大洪水
裂けよ大地=开裂的大地
震えよ世界=震动的世界
ラグナロク=诸神的黄昏

破灭皇帝弗利多
ライトニングボルト=轰雷之箭
ディヴァシティクライ=万灵之嚎
ドラウプニル・ミスト=德劳普尼尔之雾
滅びのゲシュタルト=破灭万物
創生のゲシュタルト=创生万物

巴洛尔
ティタノマキア=提坦之战
アバドン=阿巴顿
焦土の嘆き=焦土的叹息

克鲁赫
腐敗の霧=腐败之雾
破滅の雲=毁灭之云
衰亡の蝕み=衰亡之蚀

特斯拉
コロナ・ブラスト=日冕风爆
ブラック・サン=黑日
破滅の光=破灭之光



——其他——
ヴァリア・シエラ=变革的脉动
ブラック・ブレイズ=黑之炽焰
ブラック・ストーム=黑之风暴
サモン・サーバント=召唤仆从
紅のセラピア=红的治疗法
天地裏返しの術=天地逆转之术
竜呑ノ鳴門=龙吞之鸣门
桜花万華鏡=樱花万华镜
銀のプロメテイオン=银之灵血药
狂いしソウルイーター=疯狂的噬魂者
ファントム・ブレイズ=幻影炽焰
ファントム・セイバー=幻影之刃
グリムリーパー=死神收割
漆黒のピレトス=漆黑的热病
暗黒のエクソリア=暗黑的驱役
アマルティアの刻印=逐罪的刻印
闇のプロメテイオン=暗之灵血药
終焉のタナトス=终焉的死神
ケイオス・フレア=混沌耀斑
S5=S5
S4=S4
S3=S3
S2=S2
S1=S1
烈火戦槌=烈火战锤
フェイトブリンガー=命运使者
彗星炎舞=彗星炎舞
太陽の神盾=太阳神盾
星炎流舞=星炎流舞
太陽の盾=太阳之盾
暴走斬撃=暴走斩击
エデンスロウ=悠远的伊甸
タマリスク=塔玛利斯克
チャージ・スラッシュ=蓄力斩击
クロス・ブレイド=十字斩
突撃命令=突击命令
騎士の誓い=骑士之誓

王手飛車角金銀桂馬取り=王手飞车角金银桂马取
グラッジ=怨恨


