
無=無
気合いの=气势的
目潰しの=瞎眼睛的
前のめりの=向前倾的
守りに入る=进入防守
守備寄りの=偏于防守的
小遣い稼ぎの=赚零用钱的
マジカル=魔法
一服盛った=盛了一杯
駆け足の=跑步的
包帯巻きの=绷带卷的
ダテメガネの=戴眼镜的
膝に矢受けた=膝盖中箭
頭に矢受けた=头部中箭
働きたくない=不想工作

力=力
壁ドン=壁咚
レンガの=砖块的
投石の=投石的
タフな=顽强的
鉄拳の=铁拳的
勇み足の=有勇气的
人間賛歌=人间赞歌
剣壊しの=破坏剑的
盾壊しの=破坏盾的
脚壊しの=脚坏了的
頭壊しの=头坏了的
腹壊しの=坏肚子的
腰壊しの=腰坏了的
食いしばる=咬紧牙关

技=技
技ありの=有技术的
テクニカルな=技术性的
先手必勝の=先发制人
アゲアゲの=情绪高扬的
倍返し=加倍奉还
病は気から=病由心生
鶴翼の陣=鹤翼之阵
我慢強い=忍耐力强
生存本能=生存本能
点検ヨシ=检修站
軽やか=轻快
回し受け=回受
否定する=否定
弱点付与=给予弱点

知恵=智慧
火打石の=打火石的
霧吹きの=喷雾的
氷つぶての=冰疙瘩
ピカピカの=闪闪发光的
ピリっとくる=火辣辣的
小悪魔の=小恶魔的
方円の陣=方圆之阵
とんちの=机智的
コレクター=收藏家
炎を=炎
氷を=冰
風を=风
土を=土
光を=光

獣性
野獣の=野兽的
雑食の=杂食的
ハイエナの=鬣狗的
鋒矢の陣=锋矢之阵
たのしい=塔诺西
みんなの=大家的
わくわく=哇酷哇酷
上腕二頭筋=上臂二头肌
獣狩りの=狩猎野兽的
ベジタリアン=素食主义者
餓狼の=饿狼的
アニマル=动物
フレンド=朋友
デスゲーム=死亡游戏

邪鬼=邪鬼
ゴブリン=哥布林
コボルド=犬人
オーク=猪人
三種の=三种的
孕み=怀孕
魚鱗の陣=鱼鳞之阵
全力スルー=全力通过
やる気出す=鼓起干劲
有り金溶けた=失去了所有的钱
闇を=黑暗
邪鬼眼の=邪鬼眼的
雑魚敵=杂鱼敌
シャドー=阴影
アシスト=辅助

異形=异形
弱酸性=弱酸性
童心に帰る=重返童心
泥沼の=泥沼的
腹筋崩壊の=腹肌崩溃的
石の=石之
スクリュー=螺旋
カーブ=曲线
スプリット=分割
パーム=棕榈
強酸性=强酸性
女たらし=好色之徒
貫き通す=贯穿
仮面の=假面的
吸い込む=吸入

陸戦=陆战
復讐者=复仇者
行軍=行军
騎士見習いの=见习骑士的
剣折れた=剑折
十字の傷の=十字之伤的
脚粉砕の=粉碎脚的
重戦士の=重战士的
軽戦士の=轻战士的
盾粉砕の=粉碎盾的
剣粉砕の=粉碎剑的
食い破る=吃坏了
頭粉砕の=头粉碎的
斬鉄の=斩铁的
百発二十中の=百发二十中的

海原=海原
母なる海の=大海母亲的
大海原=大海原
海賊の=海盗的
お宝=珍宝
表面張力=表面张力
触手好きの=喜欢触手的
スイカ割りの=切西瓜的
水鉄砲=水铁炮
プランクトン=浮游生物
水着=水着
下着=下着
ビーチで=在沙滩上
ウェーイ=喂…
嫁の=嫁的

空飛=空飛
翼を広げた=展翅
軍師の=军师的
博士号の=博士号的
ジェットの=喷射的
色即是空=色即是空
レーサー=镭射
見切り=见切
未確認=未确认
飛び回る=飞来飞去
大気汚染の=大气污染的
指導者の=指导者的
ニョキニョキ=络绎不绝
飛行物体=飞行物体
マッパの=绘图者的

闘争=斗争
花見酒で=赏花酒
月見酒で=赏月酒
挑戦者=挑战者
狂い咲く=狂咲
渾身の=竭力的
地砕き=地碎
一杯=一杯
護身=护身
唐竹割り=劈竹
姫はじめ=一公主
研ぎ師=磨刀匠
桜吹雪の=樱吹雪
花魁の=花魁的
流れ星=流星

信念=信念
心頭滅却=心头灭却
奇跡の=奇迹的
ブースター=增压器
ステッキ=手杖
祈り=祈祷
神託=神谕
天罰の=天罚的
魔砲の=魔炮的
生者狩り=生者狩
死者狩り=死者狩
氷の鼓舞=冰的鼓舞
稲妻の鼓舞=稲妻的鼓舞
炎の鼓舞=炎的鼓舞
ステーキ=牛排

苦悶=苦闷
痺れキノコ=麻痹蘑菇
過剰摂取の=过度摄取的
薔薇トゲの=蔷薇刺的
毒手の=毒手的
狙撃兵=狙击手
最高にハイな=最高的嗨
察知する=察觉
不意打ちの=不意打的
泥棒=小偷
削り取る=削下来
ドーピングの=兴奋剂的
暗殺の=暗杀的
殺虫剤の=杀虫剂的
猛毒の=剧毒的

幻想=幻想
幻獣使いの=幻兽使的
エアバッグの=安全气囊的
機械音痴の=机械音痴的
銃騎兵殺しの=銃騎兵杀手的
幻惑の=幻惑的
修復師=修复师
マッサージ師=按摩师
除霊師=除灵师
かく乱する=搅乱
カーテン=窗帘
分身殺法=分身杀法
映画=映画
白昼夢=白日梦
っぽくみえる=看起来像

巨人=巨人
鋼の=钢的
進撃の=进攻的
巨拳の=巨拳的
破軍の=破军的
巨翼の=巨翼的
鎧の=铠甲的
頑強の=顽强的
大再生の=大再生的
巨大な=巨大
前向きに=向前看
防衛圏=防卫圈
後ろ向きな=向后看
ぶちかまし=突飞猛扑
巨大怪獣=巨大怪兽

恶
姑息な=姑息的
悪魔的=恶魔的
大怪盗=大怪盗
看破力=看穿力
悪魔神官=恶魔神官
いられない=不能留此
飲まずには=不喝不行
月兎の=月兔的
光合成の=光合作用的
野戦軍医の=野战军医的
地下王国の=地下王国的
背後の=背后的
闇医者の=暗医的
酒……！=酒……！

造
整備士の=维修员的
迷宮の=迷宫的
ジャマーの=扰乱的
防弾ベストの=防弹背心的
弾幕射撃の=弹幕射击的
建築士の=建筑师的
腹マイトの=腹部力量的
展開する=展开
重機=重机
スライミー=黏滑的
詠唱阻止=咏唱阻止
アルケミー=炼金术
キャンセラー=取消者
心！=心！

竜
竜撃=龙击
乱れ打ち=乱打
心臓喰い=心脏喰
捨て身=舍身
竜姫=龙姫
ドラゴン=多拉贡
暴走する=暴走
放浪料理人=流浪料理人
咆哮する=咆哮
暴竜拳=暴龙拳
波濤拳=波涛拳
金翼の=金翼的
財宝の=财宝的
竜血の=龙血的

歴戦=历战
飛翔する=飞翔
勇気ある=勇气
鉄腕の=铁腕的
戦斧の=战斧的
怒りの=愤怒的
マン=男人
先導者=先导者
魔の一撃=魔之一击
聖撃=圣击
連撃=连击

凶事=凶事
ヴァンプの=吸血鬼的
血清の=血清的
ズル賢い=狡猾
痺れ牙=麻痹牙
リベンジャー=复仇者
感染者=感染者
処刑人=行刑人

虫
痺れさせる=麻痹
凍てつく=结冰
水を飛ばす=飞水
炎を放つ=放火
劇毒の=剧毒的
魔力の塊の=魔力块的
光に満ちた=充满光明的
スイート=套房
熱い=热
溺れた=溺水了
寒い=冷
感電した=触电了
毒を浴びた=中毒了
ライダー=骑手

英
英傑の=英豪的
心臓抜きの=拔出心脏的
決死の=决死的
破壊者の=破坏者的
堅牢なる=坚固
喧嘩バトル=喧哗的争斗
威光=威光
クリティカル=会心一击
戯れ=嬉戏
エリート幽霊=精英幽灵
伝承紡ぎ=传承纺织
ワンパン=一拳

賢者=贤者
多重詠唱の=多重咏唱的
抗体の=抗体的
剣避けの=避剑的
バリアの=防御屏障的
策略の=策略的
爆破封じの=爆破封印的
賢き者=贤者
天才術士=天才术士
矢避け=避矢
妖医術=妖医术
探求者=探求者
ぬんじゃ=忍者



命=命
環境適応の=适应环境的
天の恵みの=天之恩惠的
命輝く=命辉
器の大きな=器量大
ゴッドハンド=神之手
地の恵み=地的恩惠
輪廻転生=轮回转世
命知らず=无所畏惧
野生の本能=野生的本能
クッション=靠垫

骸=骸
魂抜きの=没有灵魂的
採掘の=开采的
亜空間の=亚空间的
魔力摘出の=魔力摘出的
波動砲=波动炮
幻想世界=幻想世界
掘出物=掘出物
心臓矢受けた=心脏中箭
アンデッド=亡灵
断絶する=断绝
邪念砲=邪念炮

王者=王者
覇王連撃の=霸王连击的
覚悟の=觉悟的
引力の=引力的
大切断=大切断
宝剣=宝剑
スペード=黑桃
クラブ=俱乐部
ダイヤ=钻石
ハート=心
選ばれし=被选中的
刃を構える=举刃
振るう神鎚=挥舞神锤
射抜く神槍=发射神枪
キング=王者

使徒=使徒
ラック=架子
天の雷=天雷
侵蝕する=侵蚀
疫病=疫病
生け贄=祭品
魔性の光=魔性之光
平和の輝き=和平之辉
治癒の煌めき=治愈之光
封ずる=封印
アンラック=不幸运
看病の=看病的
天鏡の=天镜的

革新=革新
ストラトス=平流层
オゾンホール=臭氧空洞
ミルキウェイ=银河系
超幸運=超幸运
金星の=金星的
瞬きの=眨眼的
ミラーボール=玻璃球
散りゆく=散开
星の守り=星之守护
偉大なる=伟大

鬼哭=鬼哭
サツマイモ手=白薯手
プロミネンス=红炎
闇に生きる=暗中生长
デタラメ=胡说八道
ヒュンヒュン=呦呦
狂戦士の=狂战士的
全力集中の=全力以赴的
無痛症の=无痛症的
鬼狩りの=鬼狩的
呼吸の=呼吸的
雄大な=雄大的
死狂い=拼命
因果応報=因果报应
血に飢える=嗜血的

帝王=帝王
完全無欠の=完美无缺的
神域の=神域的
鍛冶王の=锻冶王的
リフレクター=反射镜
陽光に君臨す=君临阳光
夜を支配する=支配夜晚
王はただ一人=王只一人
アブソーバー=吸收装置
大結界師=大结界师
大砲界師=大砲界師
エンペラー=皇帝
イカ=乌贼

神
神狩りの=神狩的
一撃必殺の=一击必杀的
神速の=神速的
支配者=支配者
天刃=天刃
乱撃=乱撃
二撃滅殺=二撃滅殺
無に帰す=归无
竜帝の=龙帝的

尾=尾
朱雀の加護=朱雀的加护
玄武の加護=玄武的加护
白虎の加護=白虎的加护
九尾の護り=九尾的护佑
青龍の加護=青龙的加护
麒麟の加護=麒麟的加护
応龍の加護=应龙的加护
女神の加護=女神的加护
ドグマの加護=多格玛的加护
もふもふ防御=毛茸茸防御
グッドラック=祝你好运
ハピラキ=开心幸运
パズル=谜
全力回避の=全力回避的

機巧=机巧
機を統べる=统帅机械
空を統べる=统帅天空
竜を統べる=统帅龙族
魔を統べる=统帅魔族
人を統べる=统帅人类
砲撃を統べる=统帅炮击
全身矢受けた=全身中箭
ウルトラ=极端
超感覚=超感觉
玉砕覚悟=玉碎觉悟
料理マシーン=料理机器
平和主義の=和平主义的
仮想現実の=幻想现实的
爆風封印の=封印爆风的

真理=真理
聖壁の=圣壁的
創世の=创世的
血の乾きの=血的干涸的
武器崩壊の=武器崩坏的
詠唱根絶の=咏唱根绝的
魔導書崩壊の=魔导书崩坏的
具足崩壊の=盔甲崩坏的
盾崩壊の=盾崩坏的
終末の=终末的
天界殺しの=天界杀手的
根源=根源
森羅万象=森罗万象
天地開闢=天地开辟
救世主=救世主

破
羅刹の=罗刹的
リッパーの=开膛手的
阿修羅の=阿修罗之
リベンジの=复仇的
窮地回避の=回避穷境的
喰い荒らす=狼吞虎咽
天速斬撃=天速斩击
鬼神=鬼神
終わりを司る=掌管结束
全身全霊=全身全灵
無尽=无尽
心眼=心眼
未来予知=预知未来
一騎当千=一骑当千

運命=運命
汚染の=污染的
病巣の=病灶的
存在隠匿の=隐匿存在的
発狂の=发狂的
強固の=强固的
黎明の=黎明的
竜王=龙王
捌き=排序
宿命=宿命
豪運=豪运
女神=女神
フィールド=领域
ボムバリア=爆炸屏障
無為消失=无为消失

刹那=刹那
全力消化の=全力消化的
腐蝕の=腐蚀的
因果率の=因果率的
タイタンの=泰坦的
大工房の=大工房的
宇宙怪獣=宇宙怪兽
宮廷料理人=宫廷料理人
疾風迅雷=疾风迅雷
金剛不壊=金刚不坏
怪力乱神=怪力乱神
到達者=到达者
鎧袖一触=鎧袖一触
時を支配する=支配时间
刹那的な=刹那的

創世=创世
壊水の=坏水的
天炎の=天炎的
天盾の=天盾的
滅氷の=灭冰的
轟雷の=轰雷的
クリエイト=创造
覚醒者=觉醒者
黙示録=默示录
限界突破=限界突破
封絶世界=封绝世界
遮断空間=遮断空间
常闇=常暗
叡智=睿智
傲慢=傲慢

冥府=冥府
不老不死の=不老不死的
魔王の=魔王的
病魔の=病魔的
獄滅の=獄滅的
凱歌=凯歌
邪悪な猛毒=邪恶猛毒
闇の稲妻=暗的闪电
冥界の氷柱=冥界的冰柱
悪夢の水=恶梦之水
地獄の炎=地狱之火
剛撃=刚击
極めし者=极致者
狂乱=狂乱

禁忌=禁忌
空虚の=空虚的
悲憤の=悲愤的
壮絶な=壮烈的
極致の=极致的
ニノ太刀の=二之太刀的
神話=神话
天竜=天龙
存在抹消=存在抹消
塵に帰す=化为尘土
滅殺王=滅殺王
破壊神=破坏神
光速斬撃=光速斩击
立ち向かう=直面
壊音の=坏音的

楽園=乐园
無限の=无限的
至高の=至高的
頂点の=顶点的
億万長者の=亿万富翁的
古今無双の=古今无双的
異次元の=异次元的
超越者=超越者
支配領域=支配领域
究極世界=终极世界
封鎖地帯=封锁地带
金庫番=金库管理员
福音=福音
俺様ルール=俺即规则
終焉を呼ぶ=呼唤终焉



苦悶の=苦闷的
闘争の=闘争的
造魔の=造魔的
機巧の=机巧的
賢者の=贤者的
英雄の=英雄的
歴戦の=歴戦的
陸戦の=陆戦的
異形の=异形的
知恵の=知恵的
凶事の=凶事的
悪魔の=悪魔的
空飛の=空飞的
海原の=海原的
巨人の=巨人的
幻想の=幻想的
信念の=信念的
邪鬼の=邪鬼的
鬼哭の=鬼哭的
現在の=现在的
愚者の=愚者的

乱戦=乱战
秩序=秩序
混沌=混沌
計略=計略
破滅=破灭
進撃=進击


偉大な英雄王=伟大的英雄王
我らが救世主=我们的救世主
世界一の剣士=世界第一剑士
三界の支配者=三界的支配者
闇の女神にぞっこん=暗夜女神所爱
心優しき母神=温柔的母神
輝ける月の女神=辉月的女神
生命を育む=化育生命
赤髪の冥神=赤发的冥神
映画大好き=最喜欢电影
神剣の勇者=神剑的勇者
紅い流星=红色流星
紅蓮の狼=红莲之狼
昏き炎を宿す者=宿有暗炎者
ブチギレファイヤー=炽燃怒火
神杖の勇者=神杖的勇者
翠の融和を目指す者=以翠之融合为目标者
森の守護者=森林的守护者
抱擁力の塊=拥抱力之块
エルフイヤーは地獄耳=精灵耳是地狱耳
神鏡の勇者=神镜的勇者
夜刀の巫女=夜刀的巫女
南海の大商人=南海的大商人
千変万化の万華鏡=千変万化的万華鏡
地獄の沙汰も金次第=有钱能使鬼推磨
元気一杯スライム娘=充满活力的史莱姆娘
ジグラードの兵長=基古拉德的兵长
可能性の塊=可能性之块
命の芽を宿すもの=宿有生命萌芽的
スーパーリンリン=超级淋淋
魔王のメイド長=魔王的女仆长
宝石獣の使い手=宝石兽使用者
稀なる血を持つ少女=拥有稀少血脉的少女
継承された王の心=继承王者之心
お料理大好き倶楽部会長=热爱料理俱乐部会长
月神の最高司祭=月神的最高司祭
魔王の崇拝者=魔王的崇拜者
心優しき悪魔司祭=温柔的恶魔司祭
巡礼団の統率者=巡礼团的统率者
あわわわはわわ=啊哇哇哇啊哇哇
森の狩人=森之狩人
魔導弓の射手=魔导弓的射手
森の外に憧れる者=憧憬森林外者
スレンダーエルフ=纤细的精灵
ケーキデコレーター=蛋糕装饰器
影に潜むくノ一=影遁的女忍
必殺の秘刃=必殺的秘刃
霊獣の召喚者=灵兽的召唤者
時を超えし想い=超越时空的思念
這い寄る変態=潜伏的变态
審判の天使長=审判的天使长
舞踏竜姫=舞踏竜姫
竜王を継ぐ者=龙王的继承者
意外な良妻賢母=意外的贤妻良母
地獄の母竜=地狱的母龙
パクパクお姫様=大胃王公主
大いなる光の神=伟大的光之神
極聖の勇者=极圣的勇者
竜国の宰相=龙国的宰相
冥神に選ばれし巫女=被冥神选中的巫女
黒衣の少女=黒衣的少女
夢を渡る少女=梦渡的少女
天真爛漫お姫様=天真烂漫的公主
色々興味津々なの=对色色兴趣很大的
寂しがり屋の女神=容易感到寂寞的女神
死神の騎士=死神的骑士
漆黒の勇者=漆黒的勇者
テレジアの百学王=特雷吉亚的百学王
星神を崇める者=崇拜星神者
東方の豪傑=东方的豪杰
影を纏う将軍=被阴影笼罩的将军
夜刀の新鋭巫女=夜刀新锐巫女
獣人族戦士団長=兽人族战士团长
優しき歌声=温柔的歌声
混沌の錬金術師=混沌的炼金术师
誇り高き竜王=骄傲的龙王
非業の百学王=非业的百学王
禁忌を手にした者=掌握禁忌者
黄泉返りの侍大将=黄泉归来的侍大将
人の世が生んだ魍魎=人世间产生的魍魎
絶望の中に堕ちた少女=绝望中堕落的少女
古の魔女の一族=古之魔女一族
淫魔の淫魔の錬金術師=淫魔錬金術師
覚醒魔王=觉醒的魔王
疾風の猛将=疾风的猛将
ウィッチドクター=魔女医师
キルトの召使=库托的召使
鉄輪一座頭領=鉄輪一座頭領
紅の聖女=红色圣女
竜の勇者=竜之勇者
鉄の軍師=鉄之軍師
地獄王の令嬢=地狱王的女儿
魔竜の地獄王=魔竜的地獄王
狂乱の女神=狂乱的女神
気高き聖竜騎士=高洁的圣龙骑士
稀代の符術士=稀代的符术士
風の護り手=风之护手
黄金の船長=黄金的船长
闇の吸血公女=暗之吸血公女
異界の少女神=异界的少女神
破滅の進撃=破灭的进击










一杯お宝=一杯珍宝
たのしい氷の鼓舞=快乐的冰的鼓舞
無に帰す二撃滅殺=归于无的二击灭杀
無に帰す天刃=归于无的天刃
心頭滅却防衛圏=心灰意冷的防卫圈
ブースターブースター=增压器增压器
我慢強い飛行物体=忍耐力强的飞行物体
挑戦者一杯=挑战者一杯
地砕き姫はじめ=地碎公主
鶴翼の陣吸い込む=鹤翼之阵吸入
我慢強い吸い込む=忍耐力强吸入
ウェーイ吸い込む=喂吸入
見切り見切り=见切见切
鶴翼の陣飛行物体=鹤翼之阵飞行物体
鋼の飛行物体=钢的飞行物体

海に生きる者全てが私の家族なの=生活在海里的人全部都是我的家人



